season,game_type,week,gametime,away_team,away_score,home_team,home_score,result,total,overtime,away_rest,home_rest,away_moneyline,home_moneyline,spread_line,away_spread_odds,home_spread_odds,total_line,under_odds,over_odds,div_game,roof,surface,temp,wind,Score_Diff,Home_Win?
2020,REG,1,20:20,HOU,20,KC,34,14,54,0,7,7,349,-423,9.5,-105,-105,53.5,-109,-102,0,outdoors,grass,56,7,14,1
2020,REG,1,13:00,SEA,38,ATL,25,-13,63,0,7,7,102,-112,1,-105,-105,49.5,-108,-103,0,closed,fieldturf,,,-13,0
2020,REG,1,13:00,CLE,6,BAL,38,32,44,0,7,7,260,-302,7,-107,-103,47,100,-112,1,outdoors,grass,76,5,32,1
2020,REG,1,13:00,NYJ,17,BUF,27,10,44,0,7,7,242,-279,6.5,-110,100,39.5,-114,102,1,outdoors,astroturf,67,15,10,1
2020,REG,1,13:00,LV,34,CAR,30,-4,64,0,7,7,-124,134,-3,-112,-113,48,-101,-110,0,outdoors,grass,81,5,-4,0
2020,REG,1,13:00,CHI,27,DET,23,-4,50,0,7,7,116,-128,2.5,-108,-102,42.5,-108,-103,1,dome,fieldturf,,,-4,0
2020,REG,1,13:00,IND,20,JAX,27,7,47,0,7,7,-309,265,-7,-108,-102,44,-103,-108,1,outdoors,grass,80,3,7,1
2020,REG,1,13:00,GB,43,MIN,34,-9,77,0,7,7,103,-114,1,-103,-107,45,-110,-102,1,dome,sportturf,,,-9,0
2020,REG,1,13:00,MIA,11,NE,21,10,32,0,7,7,278,-327,7.5,-112,102,41.5,-110,-101,1,outdoors,grass,70,8,10,1
2020,REG,1,13:00,PHI,17,WAS,27,10,44,0,7,7,-227,200,-5.5,-106,-104,41.5,-111,-100,1,outdoors,grass,76,5,10,1
2020,REG,1,16:05,LAC,16,CIN,13,-3,29,0,7,7,-129,117,-2.5,-100,-110,41.5,-114,102,0,outdoors,grass,83,6,-3,0
2020,REG,1,16:25,TB,23,NO,34,11,57,0,7,7,174,-196,4,102,-113,48.5,-112,101,1,dome,astroturf,,,11,1
2020,REG,1,16:25,ARI,24,SF,20,-4,44,0,7,7,242,-280,7,-123,111,48.5,106,-118,1,outdoors,grass,66,6,-4,0
2020,REG,1,20:20,DAL,17,LA,20,3,37,0,7,7,103,-114,1,-103,-107,52,-111,-100,0,dome,matrixturf,,,3,1
2020,REG,1,19:15,PIT,26,NYG,16,-10,42,0,7,7,-253,221,-6,-105,-105,44,-105,-106,0,outdoors,fieldturf,71,5,-10,0
2020,REG,1,22:10,TEN,16,DEN,14,-2,30,0,7,7,-175,157,-3,-121,109,41,100,-112,0,outdoors,grass,79,10,-2,0
2020,REG,2,20:20,CIN,30,CLE,35,5,65,0,4,4,213,-243,6,-111,100,44.5,101,-113,1,outdoors,grass,65,8,5,1
2020,REG,2,13:00,NYG,13,CHI,17,4,30,0,6,7,196,-222,4.5,-105,-105,42.5,-103,-108,0,outdoors,grass,66,12,4,1
2020,REG,2,13:00,ATL,39,DAL,40,1,79,0,7,7,131,-145,3,-119,108,53,-102,-109,0,closed,fieldturf,,,1,1
2020,REG,2,13:00,DET,21,GB,42,21,63,0,7,7,245,-284,7,-113,102,51,-101,-110,1,outdoors,grass,66,12,21,1
2020,REG,2,13:00,MIN,11,IND,28,17,39,0,7,7,158,-176,3.5,-111,101,49,-107,-104,0,closed,fieldturf,,,17,1
2020,REG,2,13:00,BUF,31,MIA,28,-3,59,0,7,7,-244,214,-5.5,-109,-101,42.5,-102,-109,1,outdoors,grass,90,5,-3,0
2020,REG,2,13:00,SF,31,NYJ,13,-18,44,0,7,7,-301,259,-7,101,-111,41.5,-108,-103,0,outdoors,fieldturf,61,7,-18,0
2020,REG,2,13:00,LA,37,PHI,19,-18,56,0,7,7,111,-123,2,-107,-103,46,-105,-106,0,outdoors,grass,62,12,-18,0
2020,REG,2,13:00,DEN,21,PIT,26,5,47,0,6,6,232,-267,6,-100,-110,41,-114,102,0,outdoors,grass,64,5,5,1
2020,REG,2,13:00,CAR,17,TB,31,14,48,0,7,7,290,-342,7.5,-106,-104,47,-108,-103,1,outdoors,grass,85,17,14,1
2020,REG,2,13:00,JAX,30,TEN,33,3,63,0,7,6,254,-295,7,-116,105,44.5,-103,-108,1,outdoors,grass,72,5,3,1
2020,REG,2,16:05,WAS,15,ARI,30,15,45,0,7,7,268,-313,7.5,-120,109,46.5,-110,-101,0,closed,grass,,,15,1
2020,REG,2,16:25,BAL,33,HOU,16,-17,49,0,7,10,-344,292,-7.5,-102,-108,49.5,-118,106,0,closed,grass,,,-17,0
2020,REG,2,16:25,KC,23,LAC,20,-3,43,1,10,7,-370,311,-8.5,-104,-106,47,-110,-102,1,dome,matrixturf,,,-3,0
2020,REG,2,20:20,NE,30,SEA,35,5,65,0,7,7,177,-199,4,-102,-108,45,-113,101,0,outdoors,fieldturf,70,5,5,1
2020,REG,2,20:15,NO,24,LV,34,10,58,0,8,8,-201,180,-4,-102,-107,47.5,-109,-102,0,dome,grass,,,10,1
2020,REG,3,20:20,MIA,31,JAX,13,-18,44,0,4,4,124,-138,3,-126,114,49,-105,-106,0,outdoors,grass,81,12,-18,0
2020,REG,3,13:00,CHI,30,ATL,26,-4,56,0,7,7,122,-135,2.5,101,-111,46,-102,-109,0,closed,fieldturf,,,-4,0
2020,REG,3,13:00,LA,32,BUF,35,3,67,0,7,7,114,-126,1.5,-100,-110,46.5,-112,100,0,outdoors,astroturf,79,16,3,1
2020,REG,3,13:00,WAS,20,CLE,34,14,54,0,7,10,282,-331,7.5,-115,104,45,-101,-110,0,outdoors,grass,73,18,14,1
2020,REG,3,13:00,TEN,31,MIN,30,-1,61,0,7,7,-155,139,-3,-101,-109,49.5,-116,104,0,dome,sportturf,,,-1,0
2020,REG,3,13:00,LV,20,NE,36,16,56,0,6,7,266,-311,7,-105,-105,47,-102,-110,0,outdoors,grass,73,8,16,1
2020,REG,3,13:00,SF,36,NYG,9,-27,45,0,7,7,-149,134,-3,-101,-109,44,-111,-100,0,outdoors,fieldturf,75,2,-27,0
2020,REG,3,13:00,CIN,23,PHI,23,0,46,1,10,7,205,-233,5.5,-105,-105,46.5,100,-112,0,outdoors,grass,76,5,0,1
2020,REG,3,13:00,HOU,21,PIT,28,7,49,0,7,7,174,-196,4,-110,-100,46.5,-109,-102,0,outdoors,grass,79,6,7,1
2020,REG,3,16:05,NYJ,7,IND,36,29,43,0,7,7,491,-630,12.5,-109,-101,44,-113,101,0,closed,fieldturf,,,29,1
2020,REG,3,16:05,CAR,21,LAC,16,-5,37,0,7,7,230,-265,6,-107,-103,43.5,100,-111,0,dome,matrixturf,,,-5,0
2020,REG,3,16:25,DET,26,ARI,23,-3,49,0,7,7,193,-218,4.5,-105,-105,55.5,-113,101,0,closed,grass,,,-3,0
2020,REG,3,16:25,TB,28,DEN,10,-18,38,0,7,7,-264,230,-6,-105,-105,42.5,-103,-108,0,outdoors,grass,55,7,-18,0
2020,REG,3,16:25,DAL,31,SEA,38,7,69,0,7,7,208,-237,5.5,-104,-106,58,-116,104,0,outdoors,fieldturf,63,3,7,1
2020,REG,3,20:20,GB,37,NO,30,-7,67,0,7,6,154,-172,3.5,-112,102,52,-108,-103,0,dome,astroturf,,,-7,0
2020,REG,3,20:15,KC,34,BAL,20,-14,54,0,8,8,156,-174,3.5,-112,102,55,-115,104,0,outdoors,grass,73,8,-14,0
2020,REG,4,20:20,DEN,37,NYJ,28,-9,65,0,4,4,104,-114,1,-102,-108,41,-101,-110,0,outdoors,fieldturf,64,6,-9,0
2020,REG,4,13:00,ARI,21,CAR,31,10,52,0,7,7,-157,141,-3,-105,-105,52.5,-116,104,0,outdoors,grass,68,8,10,1
2020,REG,4,13:00,JAX,25,CIN,33,8,58,0,10,7,101,-112,1,-106,-104,50,-106,-105,0,outdoors,grass,64,6,8,1
2020,REG,4,13:00,CLE,49,DAL,38,-11,87,0,7,7,157,-175,3.5,-111,101,56.5,-112,101,0,closed,fieldturf,,,-11,0
2020,REG,4,13:00,NO,35,DET,29,-6,64,0,7,7,-155,139,-3,-103,-107,51.5,-102,-109,0,dome,fieldturf,,,-6,0
2020,REG,4,13:00,MIN,31,HOU,23,-8,54,0,7,7,154,-172,3.5,-114,104,52.5,100,-112,0,closed,grass,,,-8,0
2020,REG,4,13:00,SEA,31,MIA,23,-8,54,0,7,10,-223,196,-4.5,-106,-104,55,-113,101,0,outdoors,grass,86,13,-8,0
2020,REG,4,13:00,LAC,31,TB,38,7,69,0,7,7,282,-331,7.5,-114,103,42.5,-111,-100,0,outdoors,grass,75,6,7,1
2020,REG,4,13:00,BAL,31,WAS,17,-14,48,0,6,7,-958,692,-14.5,104,-115,45,-113,102,0,outdoors,grass,65,5,-14,0
2020,REG,4,16:05,NYG,9,LA,17,8,26,0,7,7,652,-890,13.5,-103,-107,49.5,101,-112,0,dome,matrixturf,,,8,1
2020,REG,4,16:25,IND,19,CHI,11,-8,30,0,7,7,-174,156,-3.5,102,-112,43.5,-110,-101,0,outdoors,grass,52,10,-8,0
2020,REG,4,16:25,BUF,30,LV,23,-7,53,0,7,7,-172,154,-3,-115,104,53,-108,-103,0,dome,grass,,,-7,0
2020,REG,4,20:20,PHI,25,SF,20,-5,45,0,7,7,273,-320,8.5,-116,105,45.5,-108,-103,0,outdoors,grass,84,12,-5,0
2020,REG,4,19:05,NE,10,KC,26,16,36,0,8,7,257,-299,7,-114,103,52.5,-106,-105,0,outdoors,astroturf,73,14,16,1
2020,REG,4,21:00,ATL,16,GB,30,14,46,0,8,8,195,-221,5,-110,-100,56.5,-112,100,0,outdoors,grass,53,9,14,1
2020,REG,5,20:20,TB,19,CHI,20,1,39,0,4,4,-184,164,-3.5,-102,-108,44,-109,-102,0,outdoors,grass,57,7,1,1
2020,REG,5,13:00,CAR,23,ATL,16,-7,39,0,7,6,125,-139,2.5,-101,-109,53.5,-107,-104,1,closed,fieldturf,,,-7,0
2020,REG,5,13:00,CIN,3,BAL,27,24,30,0,7,7,547,-718,12.5,-105,-105,49,-103,-108,1,outdoors,grass,69,3,24,1
2020,REG,5,13:00,JAX,14,HOU,30,16,44,0,7,7,243,-281,6.5,100,-110,55,-108,-103,1,closed,grass,,,16,1
2020,REG,5,13:00,LV,40,KC,32,-8,72,0,7,6,387,-476,11,-114,104,54.5,-102,-109,1,outdoors,astroturf,80,16,-8,0
2020,REG,5,13:00,ARI,30,NYJ,10,-20,40,0,7,10,-295,254,-7,106,-117,48.5,-112,100,0,outdoors,fieldturf,64,8,-20,0
2020,REG,5,13:00,PHI,29,PIT,38,9,67,0,7,14,312,-372,7.5,-103,-107,44,-107,-104,0,outdoors,grass,70,4,9,1
2020,REG,5,13:00,LA,30,WAS,10,-20,40,0,7,7,-305,262,-7,-101,-109,45,-108,-103,0,outdoors,grass,69,2,-20,0
2020,REG,5,16:05,MIA,43,SF,17,-26,60,0,7,7,301,-357,8.5,-119,108,50.5,-110,-101,0,outdoors,grass,73,6,-26,0
2020,REG,5,16:25,IND,23,CLE,32,9,55,0,7,7,-101,-110,1,-107,-103,48.5,-112,101,0,outdoors,grass,64,16,9,1
2020,REG,5,16:25,NYG,34,DAL,37,3,71,0,7,7,293,-347,7.5,-114,103,52,-107,-104,1,closed,fieldturf,,,3,1
2020,REG,5,20:20,MIN,26,SEA,27,1,53,0,7,7,245,-284,6.5,-105,-105,54,-112,100,0,outdoors,fieldturf,54,10,1,1
2020,REG,5,20:15,LAC,27,NO,30,3,57,1,8,8,288,-339,7,-106,-104,49.5,-118,106,0,dome,astroturf,,,3,1
2020,REG,5,19:00,BUF,16,TEN,42,26,58,0,9,16,-168,150,-3,-108,-102,52,-106,-105,0,outdoors,grass,73,3,26,1
2020,REG,6,13:00,CHI,23,CAR,16,-7,39,0,10,7,112,-124,2,-107,-103,45,-100,-111,0,outdoors,grass,63,6,-7,0
2020,REG,6,13:00,CIN,27,IND,31,4,58,0,7,7,288,-340,7.5,-108,-102,46,-105,-106,0,closed,fieldturf,,,4,1
2020,REG,6,13:00,DET,34,JAX,16,-18,50,0,14,7,-154,139,-3,-105,-105,52.5,100,-112,0,outdoors,grass,78,10,-18,0
2020,REG,6,13:00,ATL,40,MIN,23,-17,63,0,7,7,167,-188,3.5,-102,-108,53,103,-115,0,dome,sportturf,,,-17,0
2020,REG,6,13:00,DEN,18,NE,12,-6,30,0,17,13,280,-328,7,-103,-107,43.5,101,-113,0,outdoors,grass,58,7,-6,0
2020,REG,6,13:00,WAS,19,NYG,20,1,39,0,7,7,116,-128,2,-103,-107,42.5,-114,103,1,outdoors,fieldturf,62,0,1,1
2020,REG,6,13:00,BAL,30,PHI,28,-2,58,0,7,7,-422,348,-10.5,108,-119,46.5,-104,-107,0,outdoors,grass,61,7,-2,0
2020,REG,6,13:00,CLE,7,PIT,38,31,45,0,7,7,143,-159,3,-102,-108,50,-106,-105,1,outdoors,grass,61,9,31,1
2020,REG,6,13:00,HOU,36,TEN,42,6,78,1,7,5,169,-190,4,-110,100,52,-116,104,1,outdoors,grass,61,10,6,1
2020,REG,6,16:05,NYJ,0,MIA,24,24,24,0,7,7,340,-410,9.5,103,-113,46,104,-116,1,outdoors,grass,85,15,24,1
2020,REG,6,16:25,GB,10,TB,38,28,48,0,13,10,-145,131,-3,109,-121,55,-114,102,0,outdoors,grass,88,12,28,1
2020,REG,6,20:20,LA,16,SF,24,8,40,0,7,7,-124,112,-2,-103,-107,51,-102,-110,1,outdoors,grass,86,10,8,1
2020,REG,6,17:00,KC,26,BUF,17,-9,43,0,8,6,-230,203,-5.5,-104,-106,55,-109,-102,0,outdoors,astroturf,51,6,-9,0
2020,REG,6,20:15,ARI,38,DAL,10,-28,48,0,8,8,103,-114,1,-104,-106,55.5,102,-114,0,closed,fieldturf,,,-28,0
2020,REG,7,20:20,NYG,21,PHI,22,1,43,0,4,4,197,-223,5,-109,-101,44.5,-107,-104,1,outdoors,grass,70,4,1,1
2020,REG,7,13:00,DET,23,ATL,22,-1,45,0,7,7,102,-113,1,-106,-104,54,-105,-106,0,closed,fieldturf,,,-1,0
2020,REG,7,13:00,CLE,37,CIN,34,-3,71,0,7,7,-201,179,-4.5,103,-114,50,-114,102,1,outdoors,grass,48,8,-3,0
2020,REG,7,13:00,GB,35,HOU,20,-15,55,0,7,7,-140,127,-2.5,-113,102,55.5,-110,-101,0,closed,grass,,,-15,0
2020,REG,7,13:00,CAR,24,NO,27,3,51,0,7,13,271,-317,7,-107,-103,49.5,-110,-101,1,dome,astroturf,,,3,1
2020,REG,7,13:00,BUF,18,NYJ,10,-8,28,0,6,7,-391,327,-9.5,101,-111,47,-115,103,1,outdoors,fieldturf,52,8,-8,0
2020,REG,7,13:00,PIT,27,TEN,24,-3,51,0,7,7,103,-114,1,-102,-108,51,-111,-100,0,outdoors,grass,55,3,-3,0
2020,REG,7,13:00,DAL,3,WAS,25,22,28,0,6,7,-110,100,-1,-103,-107,44.5,-104,-107,1,outdoors,grass,46,5,22,1
2020,REG,7,16:05,TB,45,LV,20,-25,65,0,7,14,-192,171,-3.5,-108,-102,51.5,-106,-105,0,dome,grass,,,-25,0
2020,REG,7,16:25,KC,43,DEN,16,-27,59,0,6,7,-302,260,-7,103,-113,46,-111,-100,1,outdoors,grass,14,11,-27,0
2020,REG,7,16:25,JAX,29,LAC,39,10,68,0,7,13,325,-389,8,-108,-102,48,-113,102,0,dome,matrixturf,,,10,1
2020,REG,7,16:25,SF,33,NE,6,-27,39,0,7,7,150,-167,3,102,-113,44,-113,101,0,outdoors,grass,49,7,-27,0
2020,REG,7,20:20,SEA,34,ARI,37,3,71,1,14,6,-186,166,-3.5,-102,-108,55.5,-108,-103,1,closed,grass,,,3,1
2020,REG,7,20:15,CHI,10,LA,24,14,34,0,8,8,251,-291,6.5,101,-112,44,-109,-102,0,dome,matrixturf,,,14,1
2020,REG,8,20:20,ATL,25,CAR,17,-8,42,0,4,4,104,-115,1.5,-109,-102,52,-110,-101,1,outdoors,grass,76,8,-8,0
2020,REG,8,13:00,PIT,28,BAL,24,-4,52,0,7,14,178,-200,4,-109,-102,44,-108,-103,1,outdoors,grass,52,7,-4,0
2020,REG,8,13:00,NE,21,BUF,24,3,45,0,7,7,175,-197,4,-105,-105,41,-102,-109,1,outdoors,astroturf,41,17,3,1
2020,REG,8,13:00,TEN,20,CIN,31,11,51,0,7,7,-321,274,-7.5,107,-118,49.5,-115,103,0,outdoors,grass,48,24,11,1
2020,REG,8,13:00,LV,16,CLE,6,-10,22,0,7,7,117,-130,1,111,-123,48,-117,105,0,outdoors,grass,49,35,-10,0
2020,REG,8,13:00,IND,41,DET,21,-20,62,0,14,7,-185,165,-3.5,-103,-107,49,-102,-109,0,dome,fieldturf,,,-20,0
2020,REG,8,13:00,MIN,28,GB,22,-6,50,0,14,7,218,-249,5.5,-101,-109,47,-102,-109,1,outdoors,grass,34,23,-6,0
2020,REG,8,13:00,NYJ,9,KC,35,26,44,0,7,7,1204,-1965,20,-102,-108,49,-105,-106,0,outdoors,astroturf,52,11,26,1
2020,REG,8,13:00,LA,17,MIA,28,11,45,0,6,14,-176,157,-3.5,101,-111,46.5,-100,-111,0,outdoors,grass,86,10,11,1
2020,REG,8,16:05,LAC,30,DEN,31,1,61,0,7,7,-146,132,-3,103,-114,44.5,-106,-105,1,outdoors,grass,64,10,1,1
2020,REG,8,16:25,NO,26,CHI,23,-3,49,1,7,6,-229,202,-5.5,100,-110,41,-109,-102,0,outdoors,grass,40,20,-3,0
2020,REG,8,16:25,SF,27,SEA,37,10,64,0,7,7,-100,-110,1,-108,-102,54.5,-103,-108,1,outdoors,fieldturf,55,4,10,1
2020,REG,8,20:20,DAL,9,PHI,23,14,32,0,7,10,335,-403,10,-100,-110,43,-105,-106,1,outdoors,grass,49,17,14,1
2020,REG,8,20:15,TB,25,NYG,23,-2,48,0,8,11,-598,470,-13,105,-115,47,-115,103,0,outdoors,fieldturf,39,8,-2,0
2020,REG,9,20:20,GB,34,SF,17,-17,51,0,4,4,-246,215,-6,100,-110,48.5,-113,101,0,outdoors,grass,78,5,-17,0
2020,REG,9,13:00,DEN,27,ATL,34,7,61,0,7,10,193,-218,4.5,-108,-102,50,-101,-110,0,closed,fieldturf,,,7,1
2020,REG,9,13:00,SEA,34,BUF,44,10,78,0,7,7,-164,147,-3,-109,-101,55,-101,-110,0,outdoors,astroturf,69,4,10,1
2020,REG,9,13:00,BAL,24,IND,10,-14,34,0,7,7,-106,-104,1,-113,102,48,-114,102,0,closed,fieldturf,,,-14,0
2020,REG,9,13:00,HOU,27,JAX,25,-2,52,0,14,14,-289,249,-7,106,-117,49,-107,-104,1,outdoors,grass,79,14,-2,0
2020,REG,9,13:00,CAR,31,KC,33,2,64,0,10,7,365,-445,10,-106,-104,51.5,-102,-109,0,outdoors,astroturf,71,19,2,1
2020,REG,9,13:00,DET,20,MIN,34,14,54,0,7,7,155,-173,3,106,-117,51.5,-108,-104,1,dome,sportturf,,,14,1
2020,REG,9,13:00,CHI,17,TEN,24,7,41,0,7,7,243,-280,6.5,-107,-103,46.5,-106,-105,0,outdoors,grass,77,14,7,1
2020,REG,9,13:00,NYG,23,WAS,20,-3,43,0,6,14,145,-162,3,-105,-105,43,-102,-109,1,outdoors,grass,75,1,-3,0
2020,REG,9,16:05,LV,31,LAC,26,-5,57,0,7,7,-112,102,-1,-105,-105,52.5,-102,-109,1,dome,matrixturf,,,-5,0
2020,REG,9,16:25,MIA,34,ARI,31,-3,65,0,7,14,211,-241,6,-112,102,49,-108,-103,0,closed,grass,,,-3,0
2020,REG,9,16:25,PIT,24,DAL,19,-5,43,0,7,7,-789,591,-14,-100,-110,44,-103,-108,0,closed,fieldturf,,,-5,0
2020,REG,9,20:20,NO,38,TB,3,-35,41,0,7,6,160,-179,3,107,-118,51,-106,-105,1,outdoors,grass,77,17,-35,0
2020,REG,9,20:15,NE,30,NYJ,27,-3,57,0,8,8,-372,312,-9.5,102,-113,41.5,-105,-106,1,outdoors,fieldturf,61,2,-3,0
2020,REG,10,20:20,IND,34,TEN,17,-17,51,0,4,4,-115,105,-1,-107,-103,49,-100,-111,1,outdoors,grass,56,6,-17,0
2020,REG,10,13:00,TB,46,CAR,23,-23,69,0,7,7,-259,226,-6,-108,-102,49.5,-105,-106,1,outdoors,grass,65,15,-23,0
2020,REG,10,13:00,HOU,7,CLE,10,3,17,0,7,14,192,-217,4.5,-106,-104,46,-104,-107,0,outdoors,grass,59,25,3,1
2020,REG,10,13:00,WAS,27,DET,30,3,57,0,7,7,123,-136,2.5,100,-110,46,-111,100,0,dome,fieldturf,,,3,1
2020,REG,10,13:00,JAX,20,GB,24,4,44,0,7,10,653,-893,13.5,-105,-105,47,-104,-107,0,outdoors,grass,38,23,4,1
2020,REG,10,13:00,PHI,17,NYG,27,10,44,0,14,7,-219,194,-4.5,-106,-104,45,102,-113,1,outdoors,fieldturf,56,18,10,1
2020,REG,10,16:05,BUF,30,ARI,32,2,62,0,7,7,138,-153,3,-108,-102,55.5,-106,-105,0,closed,grass,,,2,1
2020,REG,10,16:05,DEN,12,LV,37,25,49,0,7,7,168,-188,3.5,-106,-104,50.5,-110,-101,1,dome,grass,,,25,1
2020,REG,10,16:05,LAC,21,MIA,29,8,50,0,7,7,104,-115,1,-100,-110,48.5,-107,-104,0,outdoors,grass,83,7,8,1
2020,REG,10,16:25,SEA,16,LA,23,7,39,0,7,14,132,-146,3,-115,104,55,-100,-111,1,dome,matrixturf,,,7,1
2020,REG,10,16:25,SF,13,NO,27,14,40,0,10,7,323,-387,9.5,-110,-101,49.5,-106,-105,0,dome,astroturf,,,14,1
2020,REG,10,16:25,CIN,10,PIT,36,26,46,0,14,7,255,-297,6.5,-101,-109,45.5,101,-112,1,outdoors,grass,52,21,26,1
2020,REG,10,20:20,BAL,17,NE,23,6,40,0,7,6,-318,272,-7,100,-110,44,-104,-107,0,outdoors,grass,52,13,6,1
2020,REG,10,20:15,MIN,19,CHI,13,-6,32,0,8,8,-170,152,-3.5,108,-119,44,100,-111,1,outdoors,grass,44,11,-6,0
2020,REG,11,20:20,ARI,21,SEA,28,7,49,0,4,4,147,-164,3,-105,-105,56.5,-101,-110,1,outdoors,fieldturf,48,11,7,1
2020,REG,11,13:00,TEN,30,BAL,24,-6,54,1,10,7,221,-253,6,-103,-107,50.5,-102,-109,0,outdoors,grass,53,6,-6,0
2020,REG,11,13:00,DET,0,CAR,20,20,20,0,7,7,-169,152,-3,-119,108,47,-105,-106,0,outdoors,grass,65,7,20,1
2020,REG,11,13:00,PHI,17,CLE,22,5,39,0,7,7,122,-135,2.5,-104,-106,45.5,-109,-103,0,outdoors,grass,38,8,5,1
2020,REG,11,13:00,NE,20,HOU,27,7,47,0,7,7,-147,132,-2.5,-117,106,49.5,-103,-108,0,closed,grass,,,7,1
2020,REG,11,13:00,PIT,27,JAX,3,-24,30,0,7,7,-475,386,-11,-103,-107,47,101,-113,0,outdoors,grass,72,3,-24,0
2020,REG,11,13:00,ATL,9,NO,24,15,33,0,14,7,162,-181,3.5,-109,-101,49.5,-103,-108,1,dome,astroturf,,,15,1
2020,REG,11,13:00,CIN,9,WAS,20,11,29,0,7,7,110,-121,2,-109,-101,48,-106,-105,0,outdoors,grass,57,7,11,1
2020,REG,11,16:05,MIA,13,DEN,20,7,33,0,7,7,-196,174,-4,-105,-105,46,-108,-103,0,outdoors,grass,45,7,7,1
2020,REG,11,16:05,NYJ,28,LAC,34,6,62,0,13,7,351,-425,10,-110,-101,47,-104,-107,0,dome,matrixturf,,,6,1
2020,REG,11,16:25,GB,31,IND,34,3,65,1,7,10,109,-120,1.5,-104,-106,52,102,-114,0,closed,fieldturf,,,3,1
2020,REG,11,16:25,DAL,31,MIN,28,-3,59,0,14,6,261,-304,7,-110,-100,50,-111,-101,0,dome,sportturf,,,-3,0
2020,REG,11,20:20,KC,35,LV,31,-4,66,0,14,7,-351,296,-7.5,-108,-102,56.5,-104,-107,1,dome,grass,,,-4,0
2020,REG,11,20:15,LA,27,TB,24,-3,51,0,8,8,173,-195,4,-109,-102,47.5,-109,-102,0,outdoors,grass,69,5,-3,0
2020,REG,12,12:30,HOU,41,DET,25,-16,66,0,4,4,-155,139,-3,-104,-106,52.5,-110,-101,0,dome,fieldturf,,,-16,0
2020,REG,12,16:30,WAS,41,DAL,16,-25,57,0,4,4,122,-135,2.5,-104,-106,46,-105,-106,1,closed,fieldturf,,,-25,0
2020,REG,12,13:00,LV,6,ATL,43,37,49,0,7,7,-184,164,-3.5,-105,-105,53,-109,-102,0,closed,fieldturf,,,37,1
2020,REG,12,13:00,LAC,17,BUF,27,10,44,0,7,14,189,-214,4.5,-107,-103,51,103,-114,0,outdoors,astroturf,48,7,10,1
2020,REG,12,13:00,NYG,19,CIN,17,-2,36,0,14,7,-260,227,-6.5,-103,-107,45,-109,-102,0,outdoors,grass,52,4,-2,0
2020,REG,12,13:00,TEN,45,IND,26,-19,71,0,7,7,133,-147,3,-114,103,51.5,-107,-104,1,closed,fieldturf,,,-19,0
2020,REG,12,13:00,CLE,27,JAX,25,-2,52,0,7,7,-334,284,-7.5,102,-112,48.5,-112,100,0,outdoors,grass,70,1,-2,0
2020,REG,12,13:00,CAR,27,MIN,28,1,55,0,7,7,131,-145,3,-115,104,50,-104,-107,0,dome,sportturf,,,1,1
2020,REG,12,13:00,ARI,17,NE,20,3,37,0,10,7,-115,104,-1,-107,-103,51,-106,-105,0,outdoors,grass,52,8,3,1
2020,REG,12,13:00,MIA,20,NYJ,3,-17,23,0,7,7,-350,296,-7.5,-106,-104,46,100,-112,1,outdoors,fieldturf,54,2,-17,0
2020,REG,12,16:05,NO,31,DEN,3,-28,34,0,7,7,-1350,906,-17,-103,-107,36.5,-109,-102,0,outdoors,grass,38,6,-28,0
2020,REG,12,16:05,SF,23,LA,20,-3,43,0,14,6,190,-215,5,-112,101,44.5,-101,-110,1,dome,matrixturf,,,-3,0
2020,REG,12,16:25,KC,27,TB,24,-3,51,0,7,6,-166,149,-3.5,112,-124,56,-103,-108,0,outdoors,grass,81,5,-3,0
2020,REG,12,20:20,CHI,25,GB,41,16,66,0,13,7,293,-346,7.5,-116,105,44,-105,-106,1,outdoors,grass,37,13,16,1
2020,REG,12,20:15,SEA,23,PHI,17,-6,40,0,11,8,-274,237,-6.5,-106,-104,50,-108,-103,0,outdoors,grass,60,16,-6,0
2020,REG,12,15:40,BAL,14,PIT,19,5,33,0,10,10,416,-518,10.5,-109,-101,41.5,-104,-107,1,outdoors,grass,36,14,5,1
2020,REG,13,13:00,NO,21,ATL,16,-5,37,0,7,7,-141,127,-2.5,-113,102,46,-101,-110,1,closed,fieldturf,,,-5,0
2020,REG,13,13:00,DET,34,CHI,30,-4,64,0,10,7,145,-161,3,-100,-110,44,-108,-104,1,outdoors,grass,35,5,-4,0
2020,REG,13,13:00,IND,26,HOU,20,-6,46,0,7,10,-176,157,-3.5,101,-112,50,-105,-106,1,closed,grass,,,-6,0
2020,REG,13,13:00,CIN,7,MIA,19,12,26,0,7,7,397,-491,10.5,-115,105,43,-103,-109,0,outdoors,grass,81,5,12,1
2020,REG,13,13:00,JAX,24,MIN,27,3,51,1,7,7,365,-445,10.5,-118,107,51,103,-114,0,dome,sportturf,,,3,1
2020,REG,13,13:00,LV,31,NYJ,28,-3,59,0,7,7,-349,295,-7.5,103,-113,48,104,-116,0,outdoors,fieldturf,39,18,-3,0
2020,REG,13,13:00,CLE,41,TEN,35,-6,76,0,7,7,178,-200,4,-111,101,54,-107,-104,0,outdoors,grass,52,1,-6,0
2020,REG,13,16:05,LA,38,ARI,28,-10,66,0,7,7,-144,130,-2.5,-114,103,49,-104,-107,1,closed,grass,,,-10,0
2020,REG,13,16:05,NYG,17,SEA,12,-5,29,0,7,6,413,-514,11,-114,104,48.5,-102,-110,0,outdoors,fieldturf,51,4,-5,0
2020,REG,13,16:25,PHI,16,GB,30,14,46,0,6,7,328,-393,8,-102,-108,50,-107,-104,0,outdoors,grass,34,9,14,1
2020,REG,13,16:25,NE,45,LAC,0,-45,45,0,7,7,117,-129,2.5,-109,-102,47,-112,100,0,dome,matrixturf,,,-45,0
2020,REG,13,20:20,DEN,16,KC,22,6,38,0,7,7,510,-660,13,-120,108,51,-101,-111,1,outdoors,astroturf,41,9,6,1
2020,REG,13,17:00,WAS,23,PIT,17,-6,40,0,11,5,231,-265,5.5,-100,-110,43.5,-101,-110,0,outdoors,grass,34,10,-6,0
2020,REG,13,20:15,BUF,34,SF,24,-10,58,0,8,8,110,-122,1.5,-103,-107,48,-103,-108,0,closed,grass,,,-10,0
2020,REG,13,20:05,DAL,17,BAL,34,17,51,0,12,6,326,-390,8.5,-103,-108,46,-108,-103,0,outdoors,grass,38,9,17,1
2020,REG,14,20:20,NE,3,LA,24,21,27,0,4,4,201,-228,5,-103,-107,43.5,-102,-110,0,dome,matrixturf,,,21,1
2020,REG,14,13:00,DEN,32,CAR,27,-5,59,0,7,14,177,-199,4,-101,-109,46,-101,-110,0,outdoors,grass,70,7,-5,0
2020,REG,14,13:00,HOU,7,CHI,36,29,43,0,7,7,-114,104,-1,-107,-103,46,101,-112,0,outdoors,grass,34,1,29,1
2020,REG,14,13:00,DAL,30,CIN,7,-23,37,0,5,7,-164,148,-3,-114,103,44,-106,-105,0,outdoors,grass,44,5,-23,0
2020,REG,14,13:00,TEN,31,JAX,10,-21,41,0,7,7,-364,307,-7.5,-106,-104,53,-112,101,1,outdoors,grass,69,2,-21,0
2020,REG,14,13:00,KC,33,MIA,27,-6,60,0,7,7,-330,281,-7.5,109,-121,51.5,-102,-109,0,outdoors,grass,81,8,-6,0
2020,REG,14,13:00,ARI,26,NYG,7,-19,33,0,7,7,-154,139,-3,-106,-104,47,-101,-111,0,outdoors,fieldturf,59,15,-19,0
2020,REG,14,13:00,MIN,14,TB,26,12,40,0,7,14,271,-317,7,-106,-104,52.5,-116,104,0,outdoors,grass,78,5,12,1
2020,REG,14,16:05,IND,44,LV,27,-17,71,0,7,7,-130,118,-2.5,-104,-106,51.5,-103,-108,0,dome,grass,,,-17,0
2020,REG,14,16:05,NYJ,3,SEA,40,37,43,0,7,7,734,-1032,16.5,-110,-100,49.5,105,-117,0,outdoors,fieldturf,43,8,37,1
2020,REG,14,16:25,GB,31,DET,24,-7,55,0,7,7,-345,292,-9.5,106,-117,55.5,-105,-106,1,dome,fieldturf,,,-7,0
2020,REG,14,16:25,ATL,17,LAC,20,3,37,0,7,7,107,-118,1,100,-110,49,-101,-111,0,dome,matrixturf,,,3,1
2020,REG,14,16:25,NO,21,PHI,24,3,45,0,7,7,-335,284,-7.5,-104,-106,43,-106,-105,0,outdoors,grass,57,10,3,1
2020,REG,14,16:25,WAS,23,SF,15,-8,38,0,6,6,134,-149,3,-111,101,43.5,-104,-107,0,closed,grass,,,-8,0
2020,REG,14,20:20,PIT,15,BUF,26,11,41,0,6,6,112,-124,2,-109,-102,48.5,-106,-105,0,outdoors,astroturf,35,11,11,1
2020,REG,14,20:15,BAL,47,CLE,42,-5,89,0,6,8,-174,156,-3,-116,105,45.5,-100,-111,1,outdoors,grass,34,18,-5,0
2020,REG,15,20:20,LAC,30,LV,27,-3,57,1,4,4,156,-174,3.5,-123,111,52,-101,-110,1,dome,grass,,,-3,0
2020,REG,15,16:30,BUF,48,DEN,19,-29,67,0,6,6,-242,212,-5.5,-105,-105,49,-103,-108,0,outdoors,grass,47,24,-29,0
2020,REG,15,20:15,CAR,16,GB,24,8,40,0,6,6,346,-419,9.5,-103,-107,53,-104,-107,0,outdoors,grass,33,5,8,1
2020,REG,15,13:00,TB,31,ATL,27,-4,58,0,7,7,-258,225,-6,-104,-106,49.5,-103,-108,1,closed,fieldturf,,,-4,0
2020,REG,15,13:00,JAX,14,BAL,40,26,54,0,7,6,564,-746,13,-118,107,49.5,-110,-101,0,outdoors,grass,39,3,26,1
2020,REG,15,13:00,SF,33,DAL,41,8,74,0,7,7,-202,180,-4,-106,-104,46,-106,-105,0,closed,fieldturf,,,8,1
2020,REG,15,13:00,HOU,20,IND,27,7,47,0,7,7,311,-370,7.5,-108,-102,52.5,-106,-105,1,closed,fieldturf,,,7,1
2020,REG,15,13:00,NE,12,MIA,22,10,34,0,10,7,-120,109,-1.5,-106,-104,40,100,-112,1,outdoors,grass,79,9,10,1
2020,REG,15,13:00,CHI,33,MIN,27,-6,60,0,7,7,137,-152,2.5,111,-123,47.5,-111,-101,1,dome,sportturf,,,-6,0
2020,REG,15,13:00,DET,25,TEN,46,21,71,0,7,7,325,-389,9.5,-113,102,54.5,-109,-103,0,outdoors,grass,46,5,21,1
2020,REG,15,13:00,SEA,20,WAS,15,-5,35,0,7,7,-251,219,-6,-103,-107,44.5,-103,-108,0,outdoors,grass,43,8,-5,0
2020,REG,15,16:05,PHI,26,ARI,33,7,59,0,7,7,226,-259,6.5,-114,103,49.5,-103,-108,0,closed,grass,,,7,1
2020,REG,15,16:05,NYJ,23,LA,20,-3,43,0,7,10,957,-1601,17.5,-115,104,44.5,-102,-110,0,dome,matrixturf,,,-3,0
2020,REG,15,16:25,KC,32,NO,29,-3,61,0,7,7,-137,124,-2.5,-113,102,53.5,101,-112,0,dome,astroturf,,,-3,0
2020,REG,15,20:20,CLE,20,NYG,6,-14,26,0,6,7,-271,235,-6,-108,-102,44.5,-100,-111,0,outdoors,fieldturf,36,0,-14,0
2020,REG,15,20:15,PIT,17,CIN,27,10,44,0,8,8,-942,682,-14.5,-101,-109,40.5,-107,-104,1,outdoors,grass,43,10,10,1
2020,REG,16,16:30,MIN,33,NO,52,19,85,0,5,5,260,-302,6.5,-109,-102,49,-109,-102,0,dome,astroturf,,,19,1
2020,REG,16,13:00,TB,47,DET,7,-40,54,0,6,6,-591,455,-12,101,-111,55,-107,-104,0,dome,fieldturf,,,-40,0
2020,REG,16,16:30,SF,20,ARI,12,-8,32,0,6,6,242,-280,6,-108,-102,49,-104,-107,1,closed,grass,,,-8,0
2020,REG,16,20:15,MIA,26,LV,25,-1,51,0,6,9,-125,113,-2,-104,-106,50,101,-112,0,dome,grass,,,-1,0
2020,REG,16,13:00,NYG,13,BAL,27,14,40,0,7,7,348,-420,10,-116,105,43.5,-110,-101,0,outdoors,grass,38,3,14,1
2020,REG,16,13:00,CIN,37,HOU,31,-6,68,0,6,7,276,-324,7.5,-113,102,46,-105,-106,0,closed,grass,,,-6,0
2020,REG,16,13:00,CHI,41,JAX,17,-24,58,0,7,7,-452,370,-9.5,-108,-103,47,-105,-106,0,outdoors,grass,55,5,-24,0
2020,REG,16,13:00,ATL,14,KC,17,3,31,0,7,7,409,-508,11,-110,-100,54,-106,-105,0,outdoors,astroturf,49,8,3,1
2020,REG,16,13:00,CLE,16,NYJ,23,7,39,0,7,7,-303,260,-6.5,-114,103,45,-105,-106,0,outdoors,fieldturf,37,5,7,1
2020,REG,16,13:00,IND,24,PIT,28,4,52,0,7,6,-106,-104,-1,100,-111,43,-105,-106,0,outdoors,grass,37,6,4,1
2020,REG,16,16:05,DEN,16,LAC,19,3,35,0,8,10,113,-125,2.5,-111,100,47.5,-104,-108,1,dome,matrixturf,,,3,1
2020,REG,16,16:05,CAR,20,WAS,13,-7,33,0,8,7,-112,102,-1,-105,-105,41,102,-114,0,outdoors,grass,41,6,-7,0
2020,REG,16,16:25,PHI,17,DAL,37,20,54,0,7,7,-166,149,-3,-115,104,50,-103,-108,1,closed,fieldturf,,,20,1
2020,REG,16,16:25,LA,9,SEA,20,11,29,0,7,7,115,-127,1.5,103,-114,48,-111,100,1,outdoors,fieldturf,45,2,11,1
2020,REG,16,20:20,TEN,14,GB,40,26,54,0,7,8,159,-177,3,107,-118,52.5,-104,-107,0,outdoors,grass,28,15,26,1
2020,REG,16,20:15,BUF,38,NE,9,-29,47,0,9,8,-313,268,-7,-102,-108,47,100,-112,1,outdoors,grass,41,4,-29,0
2020,REG,17,13:00,MIA,26,BUF,56,30,82,0,8,6,-153,138,-3.5,113,-125,42.5,102,-114,1,outdoors,astroturf,35,1,30,1
2020,REG,17,13:00,BAL,38,CIN,3,-35,41,0,7,7,-799,597,-13.5,106,-117,46,-109,-102,1,outdoors,grass,39,10,-35,0
2020,REG,17,13:00,PIT,22,CLE,24,2,46,0,7,7,376,-460,10.5,-111,100,45,-112,101,1,outdoors,grass,38,7,2,1
2020,REG,17,13:00,MIN,37,DET,35,-2,72,0,9,8,-161,145,-3,-110,-100,54,-112,101,1,dome,fieldturf,,,-2,0
2020,REG,17,13:00,NYJ,14,NE,28,14,42,0,7,6,145,-161,3,-101,-110,41,-102,-109,1,outdoors,grass,33,5,14,1
2020,REG,17,13:00,DAL,19,NYG,23,4,42,0,7,7,-121,109,-1.5,-106,-104,44.5,-109,-103,1,outdoors,fieldturf,33,6,4,1
2020,REG,17,13:00,ATL,27,TB,44,17,71,0,7,8,276,-323,7.5,-123,111,51,-100,-111,1,outdoors,grass,65,4,17,1
2020,REG,17,16:25,NO,33,CAR,7,-26,40,0,9,7,-250,219,-6,100,-110,47,-108,-104,1,outdoors,grass,57,2,-26,0
2020,REG,17,16:25,GB,35,CHI,16,-19,51,0,7,7,-207,184,-4.5,-103,-107,48.5,-112,100,1,outdoors,grass,32,7,-19,0
2020,REG,17,16:25,LV,32,DEN,31,-1,63,0,8,7,-144,130,-2.5,-115,104,50.5,-103,-108,1,outdoors,grass,53,10,-1,0
2020,REG,17,16:25,TEN,41,HOU,38,-3,79,0,7,7,-301,259,-7,101,-111,55.5,-113,101,1,closed,grass,,,-3,0
2020,REG,17,16:25,JAX,14,IND,28,14,42,0,7,7,906,-1350,15.5,104,-115,48,-112,100,1,closed,fieldturf,,,14,1
2020,REG,17,16:25,LAC,38,KC,21,-17,59,0,7,7,-282,244,-7,106,-117,43,-103,-108,1,outdoors,astroturf,35,6,-17,0
2020,REG,17,16:25,ARI,7,LA,18,11,25,0,8,7,113,-125,1,105,-116,42,-107,-104,1,dome,matrixturf,,,11,1
2020,REG,17,16:25,SEA,26,SF,23,-3,49,0,7,8,-310,266,-7,101,-112,45,-113,102,1,closed,grass,,,-3,0
2020,REG,17,20:20,WAS,20,PHI,14,-6,34,0,7,7,-283,245,-6.5,-109,-101,43.5,101,-112,1,outdoors,grass,38,10,-6,0
2021,REG,1,20:20,DAL,29,TB,31,2,60,0,7,7,351,-425,10,-121,110,52.5,-108,-103,0,outdoors,grass ,82,9,2,1
2021,REG,1,13:00,PHI,32,ATL,6,-26,38,0,7,7,161,-180,3.5,-109,-101,49,-108,-103,0,open,fieldturf,,,-26,0
2021,REG,1,13:00,PIT,23,BUF,16,-7,39,0,7,7,232,-267,6.5,-110,-100,48,-114,103,0,outdoors,a_turf,73,17,-7,0
2021,REG,1,13:00,NYJ,14,CAR,19,5,33,0,7,7,164,-184,3.5,-108,-102,44.5,-107,-104,0,outdoors,grass ,81,0,5,1
2021,REG,1,13:00,MIN,24,CIN,27,3,51,1,7,7,-135,122,-3,109,-120,47,102,-114,0,outdoors,fieldturf,81,15,3,1
2021,REG,1,13:00,SF,41,DET,33,-8,74,0,7,7,-415,344,-9.5,-105,-105,46,-103,-108,0,dome,fieldturf,,,-8,0
2021,REG,1,13:00,JAX,21,HOU,37,16,58,0,7,7,-172,154,-3.5,103,-113,45.5,-107,-104,1,closed,astroturf,,,16,1
2021,REG,1,13:00,SEA,28,IND,16,-12,44,0,7,7,-146,132,-3,106,-117,49,-105,-106,0,closed,fieldturf,,,-12,0
2021,REG,1,13:00,ARI,38,TEN,13,-25,51,0,7,7,131,-146,2.5,105,-116,54,-103,-108,0,outdoors,grass ,82,8,-25,0
2021,REG,1,13:00,LAC,20,WAS,16,-4,36,0,7,7,117,-129,2.5,-109,-101,45.5,-115,103,0,outdoors,grass ,81,4,-4,0
2021,REG,1,16:25,CLE,29,KC,33,4,62,0,7,7,211,-241,5.5,-101,-110,54.5,-107,-105,0,outdoors,grass ,88,8,4,1
2021,REG,1,16:25,MIA,17,NE,16,-1,33,0,7,7,155,-173,3.5,-113,102,43.5,-114,103,1,outdoors,fieldturf,81,15,-1,0
2021,REG,1,16:25,GB,3,NO,38,35,41,0,7,7,-181,162,-4,103,-114,49,-110,-102,0,outdoors,grass ,86,9,35,1
2021,REG,1,16:25,DEN,27,NYG,13,-14,40,0,7,7,-139,125,-3,109,-120,41.5,-105,-106,0,outdoors,fieldturf,82,19,-14,0
2021,REG,1,20:20,CHI,14,LA,34,20,48,0,7,7,324,-387,9.5,-108,-102,46,-107,-104,0,dome,matrixturf,,,20,1
2021,REG,1,20:15,BAL,27,LV,33,6,60,1,7,7,-167,149,-3,-116,105,50.5,-111,-100,0,dome,grass,,,6,1
2021,REG,2,20:20,NYG,29,WAS,30,1,59,0,4,4,176,-198,4,-103,-107,42,-112,100,1,outdoors,grass ,71,0,1,1
2021,REG,2,13:00,NO,7,CAR,26,19,33,0,7,7,-145,131,-3,102,-113,45,-106,-105,1,outdoors,grass ,83,4,19,1
2021,REG,2,13:00,CIN,17,CHI,20,3,37,0,7,7,114,-126,2,-105,-105,44.5,-107,-104,0,outdoors,grass ,80,0,3,1
2021,REG,2,13:00,HOU,21,CLE,31,10,52,0,7,7,521,-675,13.5,-103,-107,48.5,103,-115,0,outdoors,grass ,75,12,10,1
2021,REG,2,13:00,LA,27,IND,24,-3,51,0,7,7,-205,182,-4,-110,-100,48,-115,103,0,closed,fieldturf,,,-3,0
2021,REG,2,13:00,DEN,23,JAX,13,-10,36,0,7,7,-241,211,-6,104,-115,45,-107,-104,0,outdoors,grass ,80,7,-10,0
2021,REG,2,13:00,BUF,35,MIA,0,-35,35,0,7,7,-179,160,-3.5,103,-113,48,-103,-109,1,outdoors,grass ,89,7,-35,0
2021,REG,2,13:00,NE,25,NYJ,6,-19,31,0,7,7,-235,207,-5.5,-105,-105,43,102,-113,1,outdoors,fieldturf,72,13,-19,0
2021,REG,2,13:00,SF,17,PHI,11,-6,28,0,7,7,-144,130,-3,104,-115,49,-109,-102,0,outdoors,grass ,76,13,-6,0
2021,REG,2,13:00,LV,26,PIT,17,-9,43,0,6,7,201,-228,5.5,-109,-102,46.5,104,-116,0,outdoors,grass ,77,4,-9,0
2021,REG,2,16:05,MIN,33,ARI,34,1,67,0,7,7,170,-191,4,-111,101,51,-111,-101,0,closed,grass ,,,1,1
2021,REG,2,16:05,ATL,25,TB,48,23,73,0,7,10,582,-772,13.5,-108,-102,52,-103,-108,1,outdoors,grass ,85,0,23,1
2021,REG,2,16:25,DAL,20,LAC,17,-3,37,0,10,7,135,-150,3,-109,-101,55,-101,-110,0,dome,matrixturf,,,-3,0
2021,REG,2,16:25,TEN,33,SEA,30,-3,63,1,7,7,247,-286,6.5,-100,-110,53.5,-102,-109,0,outdoors,fieldturf,62,14,-3,0
2021,REG,2,20:20,KC,35,BAL,36,1,71,0,7,6,-171,153,-3.5,107,-118,53.5,-110,-101,0,outdoors,grass,82,8,1,1
2021,REG,2,20:15,DET,17,GB,35,18,52,0,8,8,400,-494,11.5,-112,102,49.5,-101,-110,1,outdoors,grass ,73,12,18,1
2021,REG,3,20:20,CAR,24,HOU,9,-15,33,0,4,4,-420,348,-8,-115,104,43,-101,-110,0,closed,astroturf,,,-15,0
2021,REG,3,13:00,WAS,21,BUF,43,22,64,0,10,7,281,-330,7.5,-114,103,45.5,-105,-106,0,outdoors,a_turf,67,21,22,1
2021,REG,3,13:00,CHI,6,CLE,26,20,32,0,7,7,315,-375,7.5,-102,-108,45,-106,-105,0,outdoors,grass ,70,22,20,1
2021,REG,3,13:00,BAL,19,DET,17,-2,36,0,7,6,-344,292,-7.5,-100,-110,51,-105,-106,0,dome,fieldturf,,,-2,0
2021,REG,3,13:00,ARI,31,JAX,19,-12,50,0,7,7,-360,304,-8,-101,-110,51.5,-104,-107,0,outdoors,grass ,81,4,-12,0
2021,REG,3,13:00,LAC,30,KC,24,-6,54,0,7,7,237,-273,6.5,-100,-110,55,-108,-103,1,outdoors,grass ,81,19,-6,0
2021,REG,3,13:00,NO,28,NE,13,-15,41,0,7,7,130,-144,3,-117,106,44,-114,102,0,outdoors,fieldturf,73,11,-15,0
2021,REG,3,13:00,ATL,17,NYG,14,-3,31,0,7,10,129,-143,3,-115,105,48,-110,-101,0,outdoors,fieldturf,69,13,-3,0
2021,REG,3,13:00,CIN,24,PIT,10,-14,34,0,7,7,126,-140,2.5,103,-114,42.5,-112,101,1,outdoors,grass ,67,9,-14,0
2021,REG,3,13:00,IND,16,TEN,25,9,41,0,7,7,175,-196,4.5,-113,103,47,-104,-107,1,outdoors,grass ,72,4,9,1
2021,REG,3,16:05,NYJ,0,DEN,26,26,26,0,7,7,470,-597,10.5,-109,-101,42,-107,-104,0,outdoors,grass ,82,6,26,1
2021,REG,3,16:05,MIA,28,LV,31,3,59,1,7,7,173,-194,4,-107,-103,45,-100,-111,0,dome,grass,,,3,1
2021,REG,3,16:25,TB,24,LA,34,10,58,0,7,7,-106,-104,-1,100,-110,55,-102,-109,0,dome,matrixturf,,,10,1
2021,REG,3,16:25,SEA,17,MIN,30,13,47,0,7,7,-120,109,-2,-101,-109,53.5,-104,-107,0,dome,sportturf,,,13,1
2021,REG,3,20:20,GB,30,SF,28,-2,58,0,6,7,160,-179,3.5,-113,103,50.5,-103,-108,0,outdoors,grass,69,15,-2,0
2021,REG,3,20:15,PHI,21,DAL,41,20,62,0,8,8,168,-189,3.5,-103,-107,51.5,-110,-101,1,open,matrixturf,,,20,1
2021,REG,4,20:20,JAX,21,CIN,24,3,45,0,4,4,313,-373,7.5,105,-116,46,101,-113,0,outdoors,fieldturf,65,0,3,1
2021,REG,4,13:00,WAS,34,ATL,30,-4,64,0,7,7,-117,106,-1,-111,100,47.5,-114,102,0,open,fieldturf,,,-4,0
2021,REG,4,13:00,HOU,0,BUF,40,40,40,0,10,7,988,-1500,19,-108,-102,47.5,-106,-105,0,outdoors,a_turf,67,12,40,1
2021,REG,4,13:00,DET,14,CHI,24,10,38,0,7,7,134,-148,3,-109,-101,42,-110,-101,1,outdoors,grass ,72,4,10,1
2021,REG,4,13:00,CAR,28,DAL,36,8,64,0,10,6,186,-210,4.5,-106,-104,51.5,-114,102,0,closed,matrixturf,,,8,1
2021,REG,4,13:00,IND,27,MIA,17,-10,44,0,7,7,130,-144,2.5,102,-113,41.5,-104,-107,0,outdoors,grass ,85,16,-10,0
2021,REG,4,13:00,CLE,14,MIN,7,-7,21,0,7,7,-105,-106,-1,102,-113,52,102,-114,0,dome,sportturf,,,-7,0
2021,REG,4,13:00,NYG,27,NO,21,-6,48,1,7,7,286,-337,7.5,-118,107,43,103,-115,0,dome,sportturf,,,-6,0
2021,REG,4,13:00,TEN,24,NYJ,27,3,51,1,7,7,-234,206,-5.5,-104,-106,44.5,-106,-105,0,outdoors,fieldturf,78,9,3,1
2021,REG,4,13:00,KC,42,PHI,30,-12,72,0,7,6,-349,296,-7.5,101,-112,53.5,-105,-106,0,outdoors,grass ,73,8,-12,0
2021,REG,4,16:05,ARI,37,LA,20,-17,57,0,7,7,178,-200,3.5,100,-111,53.5,-101,-110,1,dome,matrixturf,,,-17,0
2021,REG,4,16:05,SEA,28,SF,21,-7,49,0,7,7,120,-133,2.5,-103,-107,52,-108,-103,1,outdoors,grass,80,0,-7,0
2021,REG,4,16:25,BAL,23,DEN,7,-16,30,0,7,7,107,-118,1,101,-111,44,-106,-105,0,outdoors,grass ,77,11,-16,0
2021,REG,4,16:25,PIT,17,GB,27,10,44,0,7,7,239,-276,6.5,-104,-106,45,-103,-108,0,outdoors,grass ,67,4,10,1
2021,REG,4,20:20,TB,19,NE,17,-2,36,0,7,7,-255,223,-6,-105,-105,49.5,-110,-101,0,outdoors,fieldturf,62,4,-2,0
2021,REG,4,20:15,LV,14,LAC,28,14,42,0,8,8,144,-161,3,-101,-109,52,-108,-103,1,dome,matrixturf,,,14,1
2021,REG,5,20:20,LA,26,SEA,17,-9,43,0,4,4,-135,122,-2.5,-116,105,53.5,-106,-105,1,outdoors,fieldturf,56,8,-9,0
2021,REG,5,9:30,NYJ,20,ATL,27,7,47,0,7,7,138,-153,3,-107,-103,45.5,102,-113,0,outdoors,grass,63,8,7,1
2021,REG,5,13:00,PHI,21,CAR,18,-3,39,0,7,7,126,-139,2.5,104,-114,46,-106,-105,0,outdoors,grass ,76,13,-3,0
2021,REG,5,13:00,GB,25,CIN,22,-3,47,1,7,10,-123,111,-2,-104,-106,50,-108,-104,0,outdoors,fieldturf,76,12,-3,0
2021,REG,5,13:00,NE,25,HOU,22,-3,47,0,7,7,-339,288,-8,102,-112,39.5,-112,101,0,closed,astroturf,,,-3,0
2021,REG,5,13:00,TEN,37,JAX,19,-18,56,0,7,10,-191,170,-4,-100,-110,49,-102,-109,1,outdoors,grass ,78,11,-18,0
2021,REG,5,13:00,DET,17,MIN,19,2,36,0,7,7,346,-418,10,-110,-100,49.5,102,-113,1,dome,sportturf,,,2,1
2021,REG,5,13:00,DEN,19,PIT,27,8,46,0,7,7,-124,113,-2,-106,-104,40,101,-113,0,outdoors,grass ,71,9,8,1
2021,REG,5,13:00,MIA,17,TB,45,28,62,0,7,7,448,-564,11,-100,-110,48,-104,-107,0,outdoors,grass ,84,7,28,1
2021,REG,5,13:00,NO,33,WAS,22,-11,55,0,7,7,-130,117,-2.5,-106,-104,43.5,-101,-110,0,outdoors,grass ,70,12,-11,0
2021,REG,5,16:05,CLE,42,LAC,47,5,89,0,7,6,117,-129,2.5,-106,-104,46.5,102,-114,0,dome,matrixturf,,,5,1
2021,REG,5,16:05,CHI,20,LV,9,-11,29,0,7,6,215,-245,5.5,-102,-108,46,-111,-101,0,dome,grass,,,-11,0
2021,REG,5,16:25,SF,10,ARI,17,7,27,0,7,7,231,-266,6,-110,-100,48.5,-105,-106,1,closed,grass ,,,7,1
2021,REG,5,16:25,NYG,20,DAL,44,24,64,0,7,7,285,-335,7.5,-112,102,53,104,-116,1,closed,matrixturf,,,24,1
2021,REG,5,20:20,BUF,38,KC,20,-18,58,0,7,7,121,-134,2.5,-101,-109,57,103,-114,0,outdoors,grass ,76,0,-18,0
2021,REG,5,20:15,IND,25,BAL,31,6,56,1,8,8,301,-356,7.5,-105,-105,46.5,-103,-108,0,outdoors,grass,69,6,6,1
2021,REG,6,20:20,TB,28,PHI,22,-6,50,0,4,4,-274,238,-7,103,-114,53,-107,-104,0,outdoors,grass ,74,8,-6,0
2021,REG,6,9:30,MIA,20,JAX,23,3,43,0,7,7,-122,110,-2.5,104,-115,47.5,-107,-105,0,outdoors,grass,63,11,3,1
2021,REG,6,13:00,LAC,6,BAL,34,28,40,0,7,6,149,-166,3,106,-116,50.5,105,-117,0,outdoors,grass,63,15,28,1
2021,REG,6,13:00,MIN,34,CAR,28,-6,62,1,7,7,-134,121,-2.5,-110,-100,45.5,-110,-101,0,outdoors,grass ,62,7,-6,0
2021,REG,6,13:00,GB,24,CHI,14,-10,38,0,7,7,-228,201,-5.5,-106,-104,44,-105,-106,1,outdoors,grass ,59,6,-10,0
2021,REG,6,13:00,CIN,34,DET,11,-23,45,0,7,7,-192,171,-3.5,-110,-100,46.5,-110,-101,0,dome,fieldturf,,,-23,0
2021,REG,6,13:00,HOU,3,IND,31,28,34,0,7,6,363,-442,10.5,-117,106,43.5,-111,-100,1,open,fieldturf,,,28,1
2021,REG,6,13:00,LA,38,NYG,11,-27,49,0,10,7,-328,280,-7.5,107,-118,49.5,-113,101,0,outdoors,fieldturf,61,13,-27,0
2021,REG,6,13:00,KC,31,WAS,13,-18,44,0,7,7,-255,223,-6,-105,-105,54,-106,-105,0,outdoors,grass ,62,13,-18,0
2021,REG,6,16:05,ARI,37,CLE,14,-23,51,0,7,7,129,-143,3,-117,106,48,102,-114,0,outdoors,grass ,58,23,-23,0
2021,REG,6,16:25,LV,34,DEN,24,-10,58,0,7,7,182,-205,5,-111,101,45.5,-111,-100,1,outdoors,grass ,76,8,-10,0
2021,REG,6,16:25,DAL,35,NE,29,-6,64,1,7,7,-189,169,-3.5,-108,-102,50.5,-106,-105,0,outdoors,fieldturf,62,11,-6,0
2021,REG,6,20:20,SEA,20,PIT,23,3,43,1,10,7,189,-213,5.5,-104,-106,43,-104,-107,0,outdoors,grass ,49,6,3,1
2021,REG,6,20:15,BUF,31,TEN,34,3,65,0,8,8,-239,210,-6,-102,-108,53.5,-113,101,0,outdoors,grass ,66,6,3,1
2021,REG,7,20:20,DEN,14,CLE,17,3,31,0,4,4,110,-121,2,-107,-103,40.5,-106,-105,0,outdoors,grass ,59,27,3,1
2021,REG,7,13:00,CIN,41,BAL,17,-24,58,0,7,7,236,-272,6.5,-109,-101,45.5,-102,-109,1,outdoors,grass,61,6,-24,0
2021,REG,7,13:00,WAS,10,GB,24,14,34,0,7,7,331,-397,8.5,-105,-105,48,-117,105,0,outdoors,grass ,49,11,14,1
2021,REG,7,13:00,ATL,30,MIA,28,-2,58,0,14,7,-129,117,-1.5,-113,103,48.5,-113,101,0,outdoors,grass ,85,9,-2,0
2021,REG,7,13:00,NYJ,13,NE,54,41,67,0,14,7,261,-303,7,-108,-102,43,-112,100,1,outdoors,fieldturf,52,0,41,1
2021,REG,7,13:00,CAR,3,NYG,25,22,28,0,7,7,-154,139,-3,-103,-107,42.5,-105,-106,0,outdoors,fieldturf,57,0,22,1
2021,REG,7,13:00,KC,3,TEN,27,24,30,0,7,6,-209,185,-4,-110,-100,57.5,-111,-101,0,outdoors,grass ,74,14,24,1
2021,REG,7,16:05,DET,19,LA,28,9,47,0,7,7,860,-1256,17,-116,105,51,-110,-101,0,dome,matrixturf,,,9,1
2021,REG,7,16:05,PHI,22,LV,33,11,55,0,10,7,-102,-108,1,-109,-101,48,-106,-105,0,dome,grass,,,11,1
2021,REG,7,16:25,HOU,5,ARI,31,26,36,0,7,7,1119,-1766,20.5,-111,100,47,101,-112,0,closed,grass ,,,26,1
2021,REG,7,16:25,CHI,3,TB,38,35,41,0,7,10,501,-644,12.5,-114,103,47,-110,-101,0,outdoors,grass ,83,7,35,1
2021,REG,7,20:20,IND,30,SF,18,-12,48,0,7,14,152,-169,3.5,-117,106,41.5,-102,-110,0,outdoors,grass,64,16,-12,0
2021,REG,7,20:15,NO,13,SEA,10,-3,23,0,15,8,-237,208,-6,-104,-106,42,-102,-109,0,outdoors,fieldturf,54,16,-3,0
2021,REG,8,20:20,GB,24,ARI,21,-3,45,0,4,4,242,-279,6.5,-104,-106,51,-105,-106,0,open,grass ,,,-3,0
2021,REG,8,13:00,CAR,19,ATL,13,-6,32,0,7,7,117,-129,2.5,-109,-101,47,-111,100,1,open,fieldturf,,,-6,0
2021,REG,8,13:00,MIA,11,BUF,26,15,37,0,7,13,709,-983,15,-108,-102,48.5,-103,-108,1,outdoors,a_turf,54,9,15,1
2021,REG,8,13:00,SF,33,CHI,22,-11,55,0,7,7,-210,186,-4.5,-103,-107,40,102,-114,0,outdoors,grass ,53,12,-11,0
2021,REG,8,13:00,PIT,15,CLE,10,-5,25,0,14,10,196,-222,5.5,-108,-102,43,-105,-106,1,outdoors,grass ,57,13,-5,0
2021,REG,8,13:00,PHI,44,DET,6,-38,50,0,7,7,-168,151,-3,-116,105,48.5,-110,-101,0,dome,fieldturf,,,-38,0
2021,REG,8,13:00,LA,38,HOU,22,-16,60,0,7,7,-1010,724,-17,107,-118,47,-108,-103,0,closed,astroturf,,,-16,0
2021,REG,8,13:00,TEN,34,IND,31,-3,65,1,7,7,144,-160,3,-102,-108,51,-112,101,1,open,fieldturf,,,-3,0
2021,REG,8,13:00,CIN,31,NYJ,34,3,65,0,7,7,-510,411,-11.5,-105,-105,43.5,-109,-102,0,outdoors,fieldturf,63,11,3,1
2021,REG,8,16:05,NE,27,LAC,24,-3,51,0,7,14,163,-183,3.5,-101,-109,50.5,-106,-105,0,dome,matrixturf,,,-3,0
2021,REG,8,16:05,JAX,7,SEA,31,24,38,0,14,6,171,-192,4,-105,-105,44,-101,-111,0,outdoors,fieldturf,54,8,24,1
2021,REG,8,16:25,WAS,10,DEN,17,7,27,0,7,10,170,-191,4,-108,-102,45,-116,104,0,outdoors,grass ,41,4,7,1
2021,REG,8,16:25,TB,27,NO,36,9,63,0,7,6,-188,168,-4,-101,-109,48.5,-109,-102,1,dome,sportturf,,,9,1
2021,REG,8,20:20,DAL,20,MIN,16,-4,36,0,14,14,193,-219,4.5,-109,-101,49.5,-110,-101,0,dome,sportturf,,,-4,0
2021,REG,8,20:15,NYG,17,KC,20,3,37,0,8,8,425,-530,10.5,-107,-103,53,-101,-110,0,outdoors,grass ,39,4,3,1
2021,REG,9,20:20,NYJ,30,IND,45,15,75,0,4,4,410,-509,10.5,-108,-102,46,-111,-101,0,closed,fieldturf,,,15,1
2021,REG,9,13:00,MIN,31,BAL,34,3,65,1,7,14,262,-305,7.5,-117,106,51,-109,-102,0,outdoors,grass,56,8,3,1
2021,REG,9,13:00,NE,24,CAR,6,-18,30,0,7,7,-176,157,-3.5,-101,-109,41.5,100,-111,0,outdoors,grass ,61,16,-18,0
2021,REG,9,13:00,CLE,41,CIN,16,-25,57,0,7,7,117,-129,2.5,-105,-105,47.5,-106,-105,1,outdoors,fieldturf,56,0,-25,0
2021,REG,9,13:00,DEN,30,DAL,16,-14,46,0,7,7,378,-462,10.5,-107,-103,50,-103,-108,0,closed,matrixturf,,,-14,0
2021,REG,9,13:00,BUF,6,JAX,9,3,15,0,7,7,-1101,776,-14.5,-120,109,48,-103,-108,0,outdoors,grass ,59,16,3,1
2021,REG,9,13:00,HOU,9,MIA,17,8,26,0,7,7,166,-185,4,-112,101,45,-109,-102,0,outdoors,grass ,72,19,8,1
2021,REG,9,13:00,ATL,27,NO,25,-2,52,0,7,7,240,-277,7,-117,106,43,-101,-110,1,dome,sportturf,,,-2,0
2021,REG,9,13:00,LV,16,NYG,23,7,39,0,14,6,-152,137,-3,-102,-108,47,-108,-103,0,outdoors,fieldturf,54,4,7,1
2021,REG,9,16:05,LAC,27,PHI,24,-3,51,0,7,7,-106,-104,-1,-101,-110,49.5,-105,-106,0,outdoors,grass ,54,11,-3,0
2021,REG,9,16:25,GB,7,KC,13,6,20,0,10,6,275,-322,7,-107,-104,48,-102,-109,0,outdoors,grass ,51,12,6,1
2021,REG,9,16:25,ARI,31,SF,17,-14,48,0,10,7,207,-235,5.5,-105,-105,44.5,-109,-102,1,outdoors,grass,57,8,-14,0
2021,REG,9,20:20,TEN,28,LA,16,-12,44,0,7,7,296,-350,7,103,-114,53.5,-111,-100,0,dome,matrixturf,,,-12,0
2021,REG,9,20:15,CHI,27,PIT,29,2,56,0,8,8,263,-306,7,-109,-101,40,-103,-108,0,outdoors,grass ,55,7,2,1
2021,REG,10,20:20,BAL,10,MIA,22,12,32,0,4,4,-390,326,-8.5,-106,-104,46.5,-106,-105,0,outdoors,grass ,77,4,12,1
2021,REG,10,13:00,ATL,3,DAL,43,40,46,0,7,7,328,-392,8,-105,-105,55,-108,-103,0,closed,matrixturf,,,40,1
2021,REG,10,13:00,JAX,17,IND,23,6,40,0,7,10,358,-434,10.5,-115,104,47.5,-108,-103,1,closed,fieldturf,,,6,1
2021,REG,10,13:00,CLE,7,NE,45,38,52,0,7,7,119,-132,2.5,-104,-106,45.5,-108,-103,0,outdoors,fieldturf,48,6,38,1
2021,REG,10,13:00,BUF,45,NYJ,17,-28,62,0,7,10,-685,527,-13,101,-111,47,104,-116,1,outdoors,fieldturf,47,4,-28,0
2021,REG,10,13:00,DET,16,PIT,16,0,32,1,14,6,303,-359,9,-121,110,43,-114,102,0,outdoors,grass ,37,12,0,1
2021,REG,10,13:00,NO,21,TEN,23,2,44,0,7,7,133,-147,3,-114,103,44,-109,-102,0,outdoors,grass ,53,12,2,1
2021,REG,10,13:00,TB,19,WAS,29,10,48,0,14,14,-435,359,-10,106,-117,51,-109,-102,0,outdoors,grass ,47,8,10,1
2021,REG,10,16:05,CAR,34,ARI,10,-24,44,0,7,7,280,-329,7,-103,-107,42,-113,101,0,closed,grass ,,,-24,0
2021,REG,10,16:05,MIN,27,LAC,20,-7,47,0,7,7,160,-179,3,111,-123,53.5,-104,-107,0,dome,matrixturf,,,-7,0
2021,REG,10,16:25,PHI,30,DEN,13,-17,43,0,7,7,101,-111,1,-108,-102,44.5,-103,-108,0,outdoors,grass ,57,19,-17,0
2021,REG,10,16:25,SEA,0,GB,17,17,17,0,14,7,151,-168,3,104,-115,49.5,-117,105,0,outdoors,grass ,35,11,17,1
2021,REG,10,20:20,KC,41,LV,14,-27,55,0,7,7,-147,133,-2.5,-123,111,53.5,-108,-103,1,dome,grass,,,-27,0
2021,REG,10,20:15,LA,10,SF,31,21,41,0,8,8,-177,158,-3.5,-100,-110,50,-110,-102,1,outdoors,grass,59,0,21,1
2021,REG,11,20:20,NE,25,ATL,0,-25,25,0,4,4,-329,280,-7,-111,101,47.5,-108,-103,0,closed,fieldturf,,,-25,0
2021,REG,11,13:00,IND,41,BUF,15,-26,56,0,7,7,274,-320,7.5,-116,105,49.5,-111,100,0,outdoors,a_turf,49,12,-26,0
2021,REG,11,13:00,WAS,27,CAR,21,-6,48,0,7,7,154,-172,3.5,-114,103,43,-108,-103,0,outdoors,grass ,54,0,-6,0
2021,REG,11,13:00,BAL,16,CHI,13,-3,29,0,10,13,-226,199,-5,-103,-107,43,-104,-107,0,outdoors,grass ,46,9,-3,0
2021,REG,11,13:00,DET,10,CLE,13,3,23,0,7,7,465,-590,13,-106,-104,42.5,-103,-108,0,outdoors,grass ,42,7,3,1
2021,REG,11,13:00,SF,30,JAX,10,-20,40,0,6,7,-281,243,-6.5,-106,-104,45,-103,-108,0,outdoors,grass ,68,17,-20,0
2021,REG,11,13:00,GB,31,MIN,34,3,65,0,7,7,-111,101,-1,-105,-105,48,-113,102,1,dome,sportturf,,,3,1
2021,REG,11,13:00,MIA,24,NYJ,17,-7,41,0,10,7,-181,162,-3.5,-103,-107,44.5,101,-112,1,outdoors,fieldturf,52,4,-7,0
2021,REG,11,13:00,NO,29,PHI,40,11,69,0,7,7,130,-144,2.5,106,-117,42.5,-111,-100,0,outdoors,grass ,51,4,11,1
2021,REG,11,13:00,HOU,22,TEN,13,-9,35,0,14,7,377,-462,10.5,-110,-100,44.5,-110,-101,1,outdoors,grass ,59,8,-9,0
2021,REG,11,16:05,CIN,32,LV,13,-19,45,0,14,7,-123,112,-1,-115,105,50.5,-110,-101,0,dome,grass,,,-19,0
2021,REG,11,16:25,DAL,9,KC,19,10,28,0,7,7,122,-134,2.5,-101,-110,56,-115,103,0,outdoors,grass ,57,17,10,1
2021,REG,11,16:25,ARI,23,SEA,13,-10,36,0,7,7,135,-150,2.5,111,-122,46,-113,101,1,outdoors,fieldturf,46,0,-10,0
2021,REG,11,20:20,PIT,37,LAC,41,4,78,0,7,7,220,-251,5.5,103,-114,47.5,-105,-106,0,dome,matrixturf,,,4,1
2021,REG,11,20:15,NYG,10,TB,30,20,40,0,15,8,423,-527,11.5,-113,102,49.5,-102,-109,0,outdoors,grass ,68,6,20,1
2021,REG,12,12:30,CHI,16,DET,14,-2,30,0,4,4,-129,115,-2,-107,-104,41.5,-103,-108,1,dome,fieldturf,,,-2,0
2021,REG,12,16:30,LV,36,DAL,33,-3,69,0,4,4,269,-314,7,-106,-105,51,-103,-108,0,closed,matrixturf,,,-3,0
2021,REG,12,20:20,BUF,31,NO,6,-25,37,0,4,4,-270,235,-7,100,-112,45,-110,-101,0,dome,sportturf,,,-25,0
2021,REG,12,13:00,PIT,10,CIN,41,31,51,0,7,7,154,-172,3.5,-111,-100,43.5,-102,-110,1,outdoors,fieldturf,43,12,31,1
2021,REG,12,13:00,NYJ,21,HOU,14,-7,35,0,7,7,125,-138,3,-124,111,44.5,-103,-108,0,closed,astroturf,,,-7,0
2021,REG,12,13:00,TB,38,IND,31,-7,69,0,6,7,-149,135,-3,101,-112,53,-109,-102,0,closed,fieldturf,,,-7,0
2021,REG,12,13:00,ATL,21,JAX,14,-7,35,0,10,7,-115,105,-1.5,-102,-108,46,-108,-103,0,outdoors,grass ,61,4,-7,0
2021,REG,12,13:00,CAR,10,MIA,33,23,43,0,7,7,-119,108,-1,-110,-101,41,102,-113,0,outdoors,grass ,74,4,23,1
2021,REG,12,13:00,TEN,13,NE,36,23,49,0,7,10,262,-305,7.5,-118,106,43,-103,-108,0,outdoors,fieldturf,33,6,23,1
2021,REG,12,13:00,PHI,7,NYG,13,6,20,0,7,6,-192,171,-4,100,-110,45.5,-107,-104,1,outdoors,fieldturf,39,4,6,1
2021,REG,12,16:05,LAC,13,DEN,28,15,41,0,7,14,-141,127,-2.5,-114,103,47.5,-111,-100,1,outdoors,grass ,62,0,15,1
2021,REG,12,16:25,LA,28,GB,36,8,64,0,13,7,-120,108,-2,-100,-110,47,-109,-102,0,outdoors,grass ,37,14,8,1
2021,REG,12,16:25,MIN,26,SF,34,8,60,0,7,7,164,-183,3.5,-108,-102,49,-101,-110,0,outdoors,grass,68,7,8,1
2021,REG,12,20:20,CLE,10,BAL,16,6,26,0,7,7,140,-156,3,-110,-102,47,-101,-110,1,outdoors,grass,43,0,6,1
2021,REG,12,20:15,SEA,15,WAS,17,2,32,0,8,8,-128,116,-1,-121,108,47,-116,104,0,outdoors,grass ,41,9,2,1
2021,REG,13,20:20,DAL,27,NO,17,-10,44,0,7,7,-254,222,-6,-110,100,46,-106,-105,0,dome,sportturf,,,-10,0
2021,REG,13,13:00,TB,30,ATL,17,-13,47,0,7,7,-475,387,-11,-103,-108,51,-107,-104,1,closed,fieldturf,,,-13,0
2021,REG,13,13:00,ARI,33,CHI,22,-11,55,0,14,10,-373,314,-7.5,-116,104,43.5,-101,-110,0,outdoors,grass ,34,8,-11,0
2021,REG,13,13:00,LAC,41,CIN,22,-19,63,0,7,7,127,-141,2.5,104,-116,49.5,-101,-111,0,outdoors,fieldturf,48,11,-19,0
2021,REG,13,13:00,MIN,27,DET,29,2,56,0,7,10,-296,255,-7,-104,-107,47.5,-107,-104,1,dome,fieldturf,,,2,1
2021,REG,13,13:00,IND,31,HOU,0,-31,31,0,7,7,-408,339,-10,-105,-106,45.5,-107,-104,1,closed,astroturf,,,-31,0
2021,REG,13,13:00,NYG,9,MIA,20,11,29,0,7,7,253,-293,6.5,108,-120,40,100,-111,0,outdoors,grass ,80,11,11,1
2021,REG,13,13:00,PHI,33,NYJ,18,-15,51,0,7,7,-199,177,-5,102,-113,44,-102,-109,0,outdoors,fieldturf,45,0,-15,0
2021,REG,13,16:05,JAX,7,LA,37,30,44,0,7,7,597,-796,14,-103,-108,48,-109,-102,0,dome,matrixturf,,,30,1
2021,REG,13,16:05,WAS,17,LV,15,-2,32,0,6,10,116,-128,1,108,-121,47.5,-114,103,0,dome,grass,,,-2,0
2021,REG,13,16:25,BAL,19,PIT,20,1,39,0,7,7,-195,174,-4,-104,-107,44,-109,-102,1,outdoors,grass ,50,7,1,1
2021,REG,13,16:25,SF,23,SEA,30,7,53,0,7,6,-138,125,-3,108,-120,44.5,-103,-108,1,outdoors,fieldturf,41,4,7,1
2021,REG,13,20:20,DEN,9,KC,22,13,31,0,7,14,323,-387,8.5,-106,-105,46.5,-108,-103,1,outdoors,grass ,58,22,13,1
2021,REG,13,20:15,NE,14,BUF,10,-4,24,0,8,11,132,-146,3,-116,104,40,-102,-109,1,outdoors,a_turf,36,27,-4,0
2021,REG,14,20:20,PIT,28,MIN,36,8,64,0,4,4,157,-175,3.5,-117,105,45,-104,-107,0,dome,sportturf,,,8,1
2021,REG,14,13:00,ATL,29,CAR,21,-8,50,0,7,14,123,-136,2.5,-104,-107,41,105,-116,1,outdoors,grass ,48,9,-8,0
2021,REG,14,13:00,BAL,22,CLE,24,2,46,0,7,14,135,-150,3,-104,-107,44,-103,-108,1,outdoors,grass ,46,14,2,1
2021,REG,14,13:00,SEA,33,HOU,13,-20,46,0,7,7,-401,334,-10,104,-116,40.5,105,-117,0,open,astroturf,,,-20,0
2021,REG,14,13:00,LV,9,KC,48,39,57,0,7,7,365,-444,10,-108,-103,48,-103,-108,1,outdoors,grass ,47,19,39,1
2021,REG,14,13:00,NO,30,NYJ,9,-21,39,0,10,7,-194,173,-4.5,103,-114,42,-112,100,0,outdoors,fieldturf,46,13,-21,0
2021,REG,14,13:00,JAX,0,TEN,20,20,20,0,7,14,321,-384,8.5,-108,-103,44.5,-108,-103,1,outdoors,grass ,45,0,20,1
2021,REG,14,13:00,DAL,27,WAS,20,-7,47,0,10,7,-284,246,-6.5,-115,103,48,-108,-103,1,outdoors,grass ,48,17,-7,0
2021,REG,14,16:05,DET,10,DEN,38,28,48,0,7,7,495,-635,13,-109,-102,42,-106,-105,0,outdoors,grass ,63,8,28,1
2021,REG,14,16:05,NYG,21,LAC,37,16,58,0,7,7,329,-395,9.5,-118,106,44,-108,-103,0,dome,matrixturf,,,16,1
2021,REG,14,16:25,SF,26,CIN,23,-3,49,1,7,7,-130,117,-2.5,-103,-108,49,-103,-108,0,outdoors,fieldturf,48,9,-3,0
2021,REG,14,16:25,BUF,27,TB,33,6,60,1,6,7,161,-181,3.5,-106,-105,52.5,-101,-110,0,outdoors,grass ,82,4,6,1
2021,REG,14,20:20,CHI,30,GB,45,15,75,0,7,14,498,-639,11.5,-102,-109,43,103,-114,1,outdoors,grass ,36,8,15,1
2021,REG,14,20:15,LA,30,ARI,23,-7,53,0,8,8,154,-172,3,104,-116,51,-106,-105,1,open,grass ,,,-7,0
2021,REG,15,20:20,KC,34,LAC,28,-6,62,1,4,4,-173,155,-3,-117,105,54,-113,101,1,dome,matrixturf,,,-6,0
2021,REG,15,20:20,NE,17,IND,27,10,44,0,13,14,-102,-109,-1,-101,-110,46,103,-115,0,closed,fieldturf,,,10,1
2021,REG,15,13:00,CAR,14,BUF,31,17,45,0,7,7,562,-739,14,102,-114,43,-107,-104,0,outdoors,a_turf,30,8,17,1
2021,REG,15,13:00,ARI,12,DET,30,18,42,0,6,7,-634,495,-13,-102,-109,48,-107,-104,0,dome,fieldturf,,,18,1
2021,REG,15,13:00,HOU,30,JAX,16,-14,46,0,7,7,224,-257,6,-111,-101,40,-105,-106,1,outdoors,grass,80,12,-14,0
2021,REG,15,13:00,NYJ,24,MIA,31,7,55,0,7,14,366,-445,10.5,-114,102,42,-104,-107,1,outdoors,grass,82,9,7,1
2021,REG,15,13:00,DAL,21,NYG,6,-15,27,0,7,7,-534,428,-11.5,-120,108,43,104,-116,1,outdoors,fieldturf,37,8,-15,0
2021,REG,15,13:00,TEN,13,PIT,19,6,32,0,7,10,109,-121,1,102,-114,44,-105,-106,0,outdoors,grass,32,11,6,1
2021,REG,15,16:05,CIN,15,DEN,10,-5,25,0,7,7,140,-155,3,-110,-101,45,-123,110,0,outdoors,grass,61,19,-5,0
2021,REG,15,16:05,ATL,13,SF,31,18,44,0,7,7,319,-380,9.5,-114,102,48,-106,-105,0,outdoors,grass,46,0,18,1
2021,REG,15,16:25,GB,31,BAL,30,-1,61,0,7,7,-354,299,-9.5,104,-116,45.5,-109,-102,0,outdoors,grass,43,11,-1,0
2021,REG,15,20:20,NO,9,TB,0,-9,9,0,7,7,417,-518,11.5,-101,-110,45.5,-101,-110,1,outdoors,grass,75,0,-9,0
2021,REG,15,17:00,LV,16,CLE,14,-2,30,0,7,7,-147,131,-3,-102,-109,41,-100,-111,0,outdoors,grass,40,8,-2,0
2021,REG,15,20:15,MIN,17,CHI,9,-8,26,0,11,8,-320,274,-7,-114,102,48,-114,103,1,outdoors,grass,37,8,-8,0
2021,REG,15,19:00,SEA,10,LA,20,10,30,0,7,6,298,-352,7.5,-120,108,47,-101,-110,1,dome,matrixturf,,,10,1
2021,REG,15,19:00,WAS,17,PHI,27,10,44,0,7,14,380,-465,10,-101,-110,39.5,-110,-101,1,outdoors,grass,42,7,10,1
2021,REG,16,20:20,SF,17,TEN,20,3,37,0,4,4,-171,154,-3.5,108,-120,45.5,-116,104,0,outdoors,grass,48,7,3,1
2021,REG,16,16:30,CLE,22,GB,24,2,46,0,6,6,343,-430,7.5,101,-112,46.5,-100,-111,0,outdoors,grass,35,11,2,1
2021,REG,16,20:15,IND,22,ARI,16,-6,38,0,6,6,143,-161,3,102,-114,48,-106,-105,0,closed,grass,,,-6,0
2021,REG,16,13:00,DET,16,ATL,20,4,36,0,7,7,309,-373,7.5,-106,-105,42.5,102,-113,0,open,fieldturf,,,4,1
2021,REG,16,13:00,TB,32,CAR,6,-26,38,0,7,7,-503,399,-11.5,105,-117,44.5,-113,101,1,outdoors,grass,73,8,-26,0
2021,REG,16,13:00,BAL,21,CIN,41,20,62,0,7,7,306,-369,7.5,-102,-109,43,102,-114,1,outdoors,fieldturf,52,0,20,1
2021,REG,16,13:00,LAC,29,HOU,41,12,70,0,10,7,-661,500,-13.5,102,-114,46,-108,-103,0,closed,astroturf,,,12,1
2021,REG,16,13:00,LA,30,MIN,23,-7,53,0,7,6,-177,158,-3.5,-103,-108,48.5,-100,-111,0,dome,sportturf,,,-7,0
2021,REG,16,13:00,BUF,33,NE,21,-12,54,0,7,7,102,-114,1,-106,-105,43.5,-105,-106,1,outdoors,fieldturf,38,13,-12,0
2021,REG,16,13:00,JAX,21,NYJ,26,5,47,0,7,7,114,-125,2.5,-111,100,42.5,106,-118,0,outdoors,fieldturf,47,0,5,1
2021,REG,16,13:00,NYG,10,PHI,34,24,44,0,7,7,416,-529,11,-108,-103,41,-105,-106,1,outdoors,grass,53,9,24,1
2021,REG,16,16:05,CHI,25,SEA,24,-1,49,0,6,7,268,-313,7,-103,-108,41,-109,-102,0,outdoors,fieldturf,25,11,-1,0
2021,REG,16,16:25,PIT,10,KC,36,26,46,0,7,10,328,-400,10.5,-114,102,44,-103,-109,0,outdoors,grass,60,22,26,1
2021,REG,16,16:25,DEN,13,LV,17,4,30,0,7,7,-109,-102,-1,-101,-110,42,-113,101,1,dome,grass,,,4,1
2021,REG,16,20:20,WAS,14,DAL,56,42,70,0,7,7,367,-457,10.5,-113,101,45.5,101,-112,1,closed,matrixturf,,,42,1
2021,REG,16,20:15,MIA,20,NO,3,-17,23,0,8,8,-160,143,-3,-110,-101,37.5,-105,-106,0,dome,sportturf,,,-17,0
2021,REG,17,13:00,LA,20,BAL,19,-1,39,0,7,7,-313,264,-7,-110,-101,47,-108,-103,0,outdoors,grass,59,6,-1,0
2021,REG,17,13:00,ATL,15,BUF,29,14,44,0,7,7,625,-871,14,-101,-111,46.5,-103,-108,0,outdoors,a_turf,26,11,14,1
2021,REG,17,13:00,NYG,3,CHI,29,26,32,0,7,7,245,-287,7,-115,104,36.5,-102,-109,0,outdoors,grass,25,13,26,1
2021,REG,17,13:00,KC,31,CIN,34,3,65,0,7,7,-178,157,-3.5,-103,-108,51,-102,-110,0,outdoors,fieldturf,33,13,3,1
2021,REG,17,13:00,LV,23,IND,20,-3,43,0,7,8,325,-397,8.5,100,-112,46.5,101,-113,0,closed,fieldturf,,,-3,0
2021,REG,17,13:00,JAX,10,NE,50,40,60,0,7,7,727,-1056,17.5,-109,-102,42,-108,-103,0,outdoors,fieldturf,46,4,40,1
2021,REG,17,13:00,TB,28,NYJ,24,-4,52,0,7,7,-868,623,-14.5,-101,-110,48,-104,-107,0,outdoors,fieldturf,57,9,-4,0
2021,REG,17,13:00,MIA,3,TEN,34,31,37,0,6,10,151,-170,3,106,-118,41,-104,-107,0,outdoors,grass,43,13,31,1
2021,REG,17,13:00,PHI,20,WAS,16,-4,36,0,7,7,-238,206,-6.5,103,-115,44.5,102,-113,1,outdoors,grass,62,4,-4,0
2021,REG,17,16:05,DEN,13,LAC,34,21,47,0,7,7,285,-340,8,-117,105,45.5,-108,-103,1,dome,matrixturf,,,21,1
2021,REG,17,16:05,HOU,7,SF,23,16,30,0,7,10,463,-602,14,-113,101,44,-102,-109,0,outdoors,grass,50,6,16,1
2021,REG,17,16:25,ARI,25,DAL,22,-3,47,0,8,7,225,-262,6.5,-103,-108,53,-104,-107,0,closed,matrixturf,,,-3,0
2021,REG,17,16:25,CAR,10,NO,18,8,28,0,7,6,238,-279,7,-110,-101,37,100,-112,1,dome,sportturf,,,8,1
2021,REG,17,16:25,DET,29,SEA,51,22,80,0,7,7,327,-399,8.5,103,-114,41.5,-111,-101,0,outdoors,fieldturf,37,0,22,1
2021,REG,17,20:20,MIN,10,GB,37,27,47,0,7,8,525,-702,13,-116,105,42,-100,-111,1,outdoors,grass,11,9,27,1
2021,REG,17,20:15,CLE,14,PIT,26,12,40,0,9,8,-117,105,-1,-110,-101,43.5,-111,-100,1,outdoors,grass,25,12,12,1
2021,REG,18,16:30,KC,28,DEN,24,-4,52,0,7,7,-600,435,-11.5,-110,-110,44.5,-110,-110,1,outdoors,grass,41,4,-4,0
2021,REG,18,20:15,DAL,51,PHI,26,-25,77,0,7,7,-300,235,-6.5,-110,-110,46,-110,-110,1,outdoors,grass,31,8,-25,0
2021,REG,18,13:00,PIT,16,BAL,13,-3,29,1,6,7,135,-155,3,-110,-110,41,-115,-105,1,outdoors,grass,36,0,-3,0
2021,REG,18,13:00,CIN,16,CLE,21,5,37,0,7,6,215,-265,6.5,-110,-110,38,-110,-110,1,outdoors,grass,38,22,5,1
2021,REG,18,13:00,GB,30,DET,37,7,67,0,7,7,-195,165,-4,-110,-110,45,-115,-105,1,dome,fieldturf,,,7,1
2021,REG,18,13:00,TEN,28,HOU,25,-3,53,0,7,7,-575,410,-10.5,-105,-115,43,-110,-110,1,closed,astroturf,,,-3,0
2021,REG,18,13:00,IND,11,JAX,26,15,37,0,7,7,-1000,650,-14,-110,-110,43,-110,-110,1,outdoors,grass,76,19,15,1
2021,REG,18,13:00,CHI,17,MIN,31,14,48,0,7,7,160,-190,3.5,-110,-110,45.5,-110,-110,1,dome,sportturf,,,14,1
2021,REG,18,13:00,WAS,22,NYG,7,-15,29,0,7,7,-238,206,-6,-102,-109,36,-100,-111,1,outdoors,fieldturf,38,0,-15,0
2021,REG,18,16:25,SEA,38,ARI,30,-8,68,0,7,7,190,-235,5.5,-110,-110,48,100,-120,1,open,grass,,,-8,0
2021,REG,18,16:25,NO,30,ATL,20,-10,50,0,7,7,-213,186,-4.5,-111,-100,40,102,-113,1,closed,fieldturf,,,-10,0
2021,REG,18,16:25,NYJ,10,BUF,27,17,37,0,7,7,750,-1250,16,-110,-110,43,-110,-110,1,outdoors,a_turf,36,19,17,1
2021,REG,18,16:25,SF,27,LA,24,-3,51,1,7,7,150,-170,3,-105,-115,46.5,-115,-105,1,dome,matrixturf,,,-3,0
2021,REG,18,16:25,NE,24,MIA,33,9,57,0,7,7,-250,200,-6,-110,-110,41,-110,-110,1,outdoors,grass,75,8,9,1
2021,REG,18,16:25,CAR,17,TB,41,24,58,0,7,7,375,-510,11,-110,-110,43,-105,-115,1,outdoors,grass,80,4,24,1
2021,REG,18,20:20,LAC,32,LV,35,3,67,1,7,7,-180,155,-3.5,-110,-110,48,-110,-110,1,dome,grass,,,3,1
2022,REG,1,20:20,BUF,31,LA,10,-21,41,0,7,7,-117,106,-1,-112,101,51.5,-101,-111,0,dome,matrixturf,,,-21,0
2022,REG,1,13:00,NO,27,ATL,26,-1,53,0,7,7,-228,201,-6,-103,-107,43.5,-104,-108,1,closed,fieldturf,,,-1,0
2022,REG,1,13:00,CLE,26,CAR,24,-2,50,0,7,7,114,-125,2.5,-112,102,42.5,-113,100,0,outdoors,grass,,,-2,0
2022,REG,1,13:00,SF,10,CHI,19,9,29,0,7,7,-248,217,-6.5,100,-111,38,-103,-109,0,outdoors,grass,,,9,1
2022,REG,1,13:00,PIT,23,CIN,20,-3,43,1,7,7,264,-308,7.5,-119,107,44.5,101,-113,1,outdoors,fieldturf,,,-3,0
2022,REG,1,13:00,PHI,38,DET,35,-3,73,0,7,7,-240,211,-6,-110,-100,49,-117,104,0,dome,fieldturf,,,-3,0
2022,REG,1,13:00,IND,20,HOU,20,0,40,1,7,7,-290,250,-7,-103,-107,46,-110,-102,1,closed,astroturf,,,0,1
2022,REG,1,13:00,NE,7,MIA,20,13,27,0,7,7,140,-155,3,-104,-106,47,-109,-103,1,outdoors,grass,,,13,1
2022,REG,1,13:00,BAL,24,NYJ,9,-15,33,0,7,7,-265,231,-6.5,-103,-107,44,-109,-103,0,outdoors,fieldturf,,,-15,0
2022,REG,1,13:00,JAX,22,WAS,28,6,50,0,7,7,143,-159,3,-101,-110,43.5,-110,-102,0,outdoors,grass,,,6,1
2022,REG,1,16:25,KC,44,ARI,21,-23,65,0,7,7,-252,221,-6,-107,-104,54,-110,-102,0,closed,grass,,,-23,0
2022,REG,1,16:25,LV,19,LAC,24,5,43,0,7,7,161,-180,3.5,-106,-104,52.5,-103,-109,1,dome,matrixturf,,,5,1
2022,REG,1,16:25,GB,7,MIN,23,16,30,0,7,7,113,-125,2.5,-116,105,47,-114,101,1,dome,sportturf,,,16,1
2022,REG,1,16:25,NYG,21,TEN,20,-1,41,0,7,7,209,-239,5.5,-108,-102,43.5,-101,-111,0,outdoors,grass,,,-1,0
2022,REG,1,20:20,TB,19,DAL,3,-16,22,0,7,7,-133,120,-2.5,-108,-102,49.5,-102,-110,0,closed,matrixturf,,,-16,0
2022,REG,1,20:15,DEN,16,SEA,17,1,33,0,7,7,-253,221,-6,-107,-103,44,-115,102,0,outdoors,fieldturf,,,1,1
2022,REG,2,20:15,LAC,24,KC,27,3,51,0,4,4,167,-188,4,-113,102,52.5,-101,-111,1,outdoors,grass,,,3,1
2022,REG,2,13:00,MIA,42,BAL,38,-4,80,0,7,7,148,-164,3,103,-114,44,-114,101,0,outdoors,grass,,,-4,0
2022,REG,2,13:00,NYJ,31,CLE,30,-1,61,0,7,7,207,-235,6.5,-111,100,38.5,-107,-105,0,outdoors,grass,,,-1,0
2022,REG,2,13:00,WAS,27,DET,36,9,63,0,7,7,-114,103,-1,-107,-103,48.5,-114,101,0,dome,fieldturf,,,9,1
2022,REG,2,13:00,IND,0,JAX,24,24,24,0,7,7,-157,142,-3,-107,-103,43.5,-104,-108,1,outdoors,grass,,,24,1
2022,REG,2,13:00,TB,20,NO,10,-10,30,0,7,7,-138,124,-2.5,-109,-102,44,-117,104,1,dome,sportturf,,,-10,0
2022,REG,2,13:00,CAR,16,NYG,19,3,35,0,7,7,-114,103,-1,-106,-104,44,-102,-110,0,outdoors,fieldturf,,,3,1
2022,REG,2,13:00,NE,17,PIT,14,-3,31,0,7,7,-150,135,-3,-102,-109,40,-101,-111,0,outdoors,grass,,,-3,0
2022,REG,2,16:05,ATL,27,LA,31,4,58,0,7,10,385,-473,10.5,-113,103,46.5,-116,103,0,dome,matrixturf,,,4,1
2022,REG,2,16:05,SEA,7,SF,27,20,34,0,6,7,318,-379,8.5,-113,102,40,-112,-100,1,outdoors,grass,,,20,1
2022,REG,2,16:25,CIN,17,DAL,20,3,37,0,7,7,-303,260,-7.5,110,-122,42,-104,-108,0,closed,matrixturf,,,3,1
2022,REG,2,16:25,HOU,9,DEN,16,7,25,0,7,6,391,-481,10.5,-114,103,46,-110,-102,0,outdoors,grass,,,7,1
2022,REG,2,16:25,ARI,29,LV,23,-6,52,1,7,7,197,-223,5.5,-110,100,51.5,-105,-107,0,dome,grass,,,-6,0
2022,REG,2,20:20,CHI,10,GB,27,17,37,0,7,7,348,-420,10.5,-111,100,42,-104,-108,1,outdoors,grass,,,17,1
2022,REG,2,19:15,TEN,7,BUF,41,34,48,0,8,11,329,-395,10,-115,104,47.5,-108,-104,0,outdoors,a_turf,,,34,1
2022,REG,2,20:30,MIN,7,PHI,24,17,31,0,8,8,127,-141,2.5,106,-117,49.5,-115,102,0,outdoors,grass,,,17,1
2022,REG,3,20:15,PIT,17,CLE,29,12,46,0,4,4,183,-206,4.5,-111,101,38,-107,-105,1,outdoors,grass,,,12,1
2022,REG,3,13:00,NO,14,CAR,22,8,36,0,7,7,-123,112,-2,-102,-109,41,-112,-100,1,outdoors,grass,,,8,1
2022,REG,3,13:00,HOU,20,CHI,23,3,43,0,7,7,141,-156,3,-107,-103,40,-107,-105,0,outdoors,grass,,,3,1
2022,REG,3,13:00,KC,17,IND,20,3,37,0,10,7,-199,177,-4.5,103,-114,51,-105,-107,0,open,fieldturf,,,3,1
2022,REG,3,13:00,BUF,19,MIA,21,2,40,0,6,7,-196,175,-4,-104,-106,54,-103,-109,1,outdoors,grass,,,2,1
2022,REG,3,13:00,DET,24,MIN,28,4,52,0,7,6,232,-266,6.5,-101,-110,52,-117,104,1,dome,sportturf,,,4,1
2022,REG,3,13:00,BAL,37,NE,26,-11,63,0,7,7,-143,129,-2.5,-114,104,45.5,-109,-103,0,outdoors,fieldturf,,,-11,0
2022,REG,3,13:00,CIN,27,NYJ,12,-15,39,0,7,7,-247,220,-6.5,104,-115,46,-106,-106,0,outdoors,fieldturf,,,-15,0
2022,REG,3,13:00,LV,22,TEN,24,2,46,0,7,6,-130,117,-1.5,-113,103,45.5,-109,-103,0,outdoors,grass,,,2,1
2022,REG,3,13:00,PHI,24,WAS,8,-16,32,0,6,7,-240,210,-6,102,-112,47,-101,-111,1,outdoors,grass,,,-16,0
2022,REG,3,16:05,JAX,38,LAC,10,-28,48,0,7,10,220,-252,6.5,-106,-104,46,-112,-100,0,dome,matrixturf,,,-28,0
2022,REG,3,16:25,LA,20,ARI,12,-8,32,0,7,7,-171,153,-3.5,104,-115,49,-114,102,1,closed,grass,,,-8,0
2022,REG,3,16:25,ATL,27,SEA,23,-4,50,0,7,7,-104,-106,1,-112,102,43,103,-115,0,outdoors,fieldturf,,,-4,0
2022,REG,3,16:25,GB,14,TB,12,-2,26,0,7,7,112,-123,1,105,-115,41.5,-103,-109,0,outdoors,grass,,,-2,0
2022,REG,3,20:20,SF,10,DEN,11,1,21,0,7,7,-110,-101,-1,-102,-108,44,101,-114,0,outdoors,grass,,,1,1
2022,REG,3,20:15,DAL,23,NYG,16,-7,39,0,8,8,109,-120,1,103,-113,38.5,-102,-110,1,outdoors,fieldturf,,,-7,0
2022,REG,4,20:15,MIA,15,CIN,27,12,42,0,4,4,169,-190,4,-107,-103,48.5,-103,-109,0,outdoors,fieldturf,,,12,1
2022,REG,4,9:30,MIN,28,NO,25,-3,53,0,7,7,-199,177,-4,-103,-107,42,-110,-102,0,outdoors,,,,-3,0
2022,REG,4,13:00,CLE,20,ATL,23,3,43,0,10,7,-107,-103,-1,-101,-109,48,-100,-112,0,open,fieldturf,,,3,1
2022,REG,4,13:00,BUF,23,BAL,20,-3,43,0,7,7,-172,154,-3,-117,106,50,-103,-109,0,outdoors,grass,,,-3,0
2022,REG,4,13:00,WAS,10,DAL,25,15,35,0,7,6,140,-155,3,-110,-101,40.5,-101,-111,1,closed,matrixturf,,,15,1
2022,REG,4,13:00,SEA,48,DET,45,-3,93,0,7,7,151,-169,3,103,-113,48.5,-112,-101,0,dome,fieldturf,,,-3,0
2022,REG,4,13:00,LAC,34,HOU,24,-10,58,0,7,7,-234,205,-5.5,-106,-104,45,102,-115,0,closed,astroturf,,,-10,0
2022,REG,4,13:00,TEN,24,IND,17,-7,41,0,7,7,182,-205,4.5,-105,-105,43,-102,-110,1,open,fieldturf,,,-7,0
2022,REG,4,13:00,CHI,12,NYG,20,8,32,0,7,6,130,-144,3,-120,109,39,-103,-110,0,outdoors,fieldturf,,,8,1
2022,REG,4,13:00,JAX,21,PHI,29,8,50,0,7,7,223,-256,6.5,-109,-102,44,-102,-111,0,outdoors,grass,,,8,1
2022,REG,4,13:00,NYJ,24,PIT,20,-4,44,0,7,10,145,-161,3,-102,-108,41,102,-115,0,outdoors,grass,,,-4,0
2022,REG,4,16:05,ARI,26,CAR,16,-10,42,0,7,7,102,-113,1,-104,-106,44,-113,100,0,outdoors,grass,,,-10,0
2022,REG,4,16:25,NE,24,GB,27,3,51,1,7,7,358,-435,10,-120,109,40.5,-111,-101,0,outdoors,grass,,,3,1
2022,REG,4,16:25,DEN,23,LV,32,9,55,0,7,7,124,-137,2.5,-101,-109,45.5,-110,-102,1,dome,grass,,,9,1
2022,REG,4,20:20,KC,41,TB,31,-10,72,0,7,7,113,-125,1,107,-118,46.5,102,-115,0,outdoors,grass,,,-10,0
2022,REG,4,20:15,LA,9,SF,24,15,33,0,8,8,112,-124,1,106,-116,42,-109,-103,1,outdoors,grass,,,15,1
2022,REG,5,20:15,IND,12,DEN,9,-3,21,1,4,4,159,-178,3.5,-114,104,42,-106,-106,0,outdoors,grass,,,-3,0
2022,REG,5,9:30,NYG,27,GB,22,-5,49,0,7,7,331,-397,8.5,104,-115,42,-110,-102,0,outdoors,,,,-5,0
2022,REG,5,13:00,PIT,3,BUF,38,35,41,0,7,7,568,-749,14,-108,-102,44,-103,-110,0,outdoors,a_turf,,,35,1
2022,REG,5,13:00,LAC,30,CLE,28,-2,58,0,7,7,-114,103,-1,-106,-104,47,-114,102,0,outdoors,grass,,,-2,0
2022,REG,5,13:00,HOU,13,JAX,6,-7,19,0,7,7,261,-304,7,-113,102,44,-112,-101,1,outdoors,grass,,,-7,0
2022,REG,5,13:00,CHI,22,MIN,29,7,51,0,7,7,322,-385,10,-116,105,44,-106,-106,1,dome,sportturf,,,7,1
2022,REG,5,13:00,DET,0,NE,29,29,29,0,7,7,133,-148,3,-113,102,46.5,101,-114,0,outdoors,fieldturf,,,29,1
2022,REG,5,13:00,SEA,32,NO,39,7,71,0,7,7,201,-229,5.5,-106,-104,45.5,-113,100,0,dome,sportturf,,,7,1
2022,REG,5,13:00,MIA,17,NYJ,40,23,57,0,10,7,-162,146,-3,-110,100,46,-101,-111,1,outdoors,fieldturf,,,23,1
2022,REG,5,13:00,ATL,15,TB,21,6,36,0,7,7,355,-430,10.5,-113,102,46,101,-113,1,outdoors,grass,,,6,1
2022,REG,5,13:00,TEN,21,WAS,17,-4,38,0,7,7,-110,-100,-1,-102,-108,43,-106,-106,0,outdoors,grass,,,-4,0
2022,REG,5,16:05,SF,37,CAR,15,-22,52,0,6,7,-234,206,-6,-102,-109,40,-104,-108,0,outdoors,grass,,,-22,0
2022,REG,5,16:25,PHI,20,ARI,17,-3,37,0,7,7,-222,196,-5.5,101,-111,48.5,101,-113,0,closed,grass,,,-3,0
2022,REG,5,16:25,DAL,22,LA,10,-12,32,0,7,6,195,-220,5.5,-112,102,42,-106,-106,0,dome,matrixturf,,,-12,0
2022,REG,5,20:20,CIN,17,BAL,19,2,36,0,10,7,151,-168,3,103,-114,47.5,-104,-108,1,outdoors,grass,,,2,1
2022,REG,5,20:15,LV,29,KC,30,1,59,0,8,8,275,-321,7.5,-125,113,51.5,-109,-103,1,outdoors,grass,,,1,1
2022,REG,6,20:15,WAS,12,CHI,7,-5,19,0,4,4,-120,109,-1,-112,102,38.5,-105,-107,0,outdoors,grass,,,-5,0
2022,REG,6,13:00,SF,14,ATL,28,14,42,0,7,7,-185,166,-3.5,-100,-110,46,-109,-103,0,open,fieldturf,,,14,1
2022,REG,6,13:00,NE,38,CLE,15,-23,53,0,7,7,127,-140,2.5,101,-111,43,-104,-108,0,outdoors,grass,,,-23,0
2022,REG,6,13:00,NYJ,27,GB,10,-17,37,0,7,7,305,-362,7.5,-101,-109,44.5,-101,-111,0,outdoors,grass,,,-17,0
2022,REG,6,13:00,JAX,27,IND,34,7,61,0,7,10,110,-122,1,103,-114,41,100,-113,1,open,fieldturf,,,7,1
2022,REG,6,13:00,MIN,24,MIA,16,-8,40,0,7,7,-175,157,-3,-120,109,45,-107,-105,0,outdoors,grass,,,-8,0
2022,REG,6,13:00,CIN,30,NO,26,-4,56,0,7,7,-164,148,-3,-110,100,42.5,-104,-108,0,dome,sportturf,,,-4,0
2022,REG,6,13:00,BAL,20,NYG,24,4,44,0,7,7,-234,206,-5.5,-107,-103,46,-110,-102,0,outdoors,fieldturf,,,4,1
2022,REG,6,13:00,TB,18,PIT,20,2,38,0,7,7,-386,323,-10,103,-113,47,-117,104,0,outdoors,grass,,,2,1
2022,REG,6,16:05,CAR,10,LA,24,14,34,0,7,7,343,-413,10,-112,102,41.5,-109,-103,0,dome,matrixturf,,,14,1
2022,REG,6,16:05,ARI,9,SEA,19,10,28,0,7,7,-136,123,-2.5,-106,-104,50,-102,-110,1,outdoors,fieldturf,,,10,1
2022,REG,6,16:25,BUF,24,KC,20,-4,44,0,7,6,-146,132,-2.5,-116,105,54,-105,-107,0,outdoors,grass,,,-4,0
2022,REG,6,20:20,DAL,17,PHI,26,9,43,0,7,7,252,-292,6.5,109,-120,42.5,-104,-108,1,outdoors,grass,,,9,1
2022,REG,6,20:15,DEN,16,LAC,19,3,35,1,11,8,166,-186,3.5,-103,-107,45.5,-115,102,1,dome,matrixturf,,,3,1
2022,REG,7,20:15,NO,34,ARI,42,8,76,0,4,4,126,-140,2.5,-101,-109,44,-114,101,0,open,grass,,,8,1
2022,REG,7,13:00,CLE,20,BAL,23,3,43,0,7,7,244,-282,6.5,100,-110,46,-100,-112,1,outdoors,grass,,,3,1
2022,REG,7,13:00,TB,3,CAR,21,18,24,0,7,7,-680,524,-13,-103,-107,39.5,-116,103,1,outdoors,grass,,,18,1
2022,REG,7,13:00,ATL,17,CIN,35,18,52,0,7,7,235,-271,6.5,-100,-110,47.5,100,-112,0,outdoors,fieldturf,,,18,1
2022,REG,7,13:00,DET,6,DAL,24,18,30,0,14,7,241,-278,7,-112,102,49.5,-102,-110,0,closed,matrixturf,,,18,1
2022,REG,7,13:00,NYG,23,JAX,17,-6,40,0,7,7,148,-165,3,102,-112,44,-105,-107,0,outdoors,grass,,,-6,0
2022,REG,7,13:00,IND,10,TEN,19,9,29,0,7,14,129,-143,2.5,-102,-108,43,-104,-109,1,outdoors,grass,,,9,1
2022,REG,7,13:00,GB,21,WAS,23,2,44,0,7,10,-195,173,-4,-102,-108,41.5,-105,-107,0,outdoors,grass,,,2,1
2022,REG,7,16:05,NYJ,16,DEN,9,-7,25,0,7,6,-127,115,-2,-106,-104,37,-114,101,0,outdoors,grass,,,-7,0
2022,REG,7,16:05,HOU,20,LV,38,18,58,0,14,13,278,-325,7,104,-115,46,-104,-108,0,dome,grass,,,18,1
2022,REG,7,16:25,SEA,37,LAC,23,-14,60,0,7,6,193,-219,5.5,-111,101,51.5,-114,101,0,dome,matrixturf,,,-14,0
2022,REG,7,16:25,KC,44,SF,23,-21,67,0,7,7,-106,-104,-1,102,-112,49,-114,101,0,outdoors,,,,-21,0
2022,REG,7,20:20,PIT,10,MIA,16,6,26,0,7,7,255,-297,7.5,-119,108,44.5,-107,-105,0,outdoors,grass,,,6,1
2022,REG,7,20:15,CHI,33,NE,14,-19,47,0,11,8,327,-392,9.5,-110,-100,40,-106,-106,0,outdoors,fieldturf,,,-19,0
2022,REG,8,20:15,BAL,27,TB,22,-5,49,0,4,4,116,-128,2,-104,-106,46,-102,-110,0,outdoors,grass,,,-5,0
2022,REG,8,9:30,DEN,21,JAX,17,-4,38,0,7,7,-103,-107,1,-112,101,41,-103,-109,0,outdoors,,,,-4,0
2022,REG,8,13:00,CAR,34,ATL,37,3,71,1,7,7,178,-201,4.5,-110,-100,41,-106,-106,1,closed,fieldturf,,,3,1
2022,REG,8,13:00,CHI,29,DAL,49,20,78,0,6,7,355,-430,10.5,-121,109,43,-108,-104,0,open,matrixturf,,,20,1
2022,REG,8,13:00,MIA,31,DET,27,-4,58,0,7,7,-190,169,-3.5,-112,102,52,-108,-104,0,dome,fieldturf,,,-4,0
2022,REG,8,13:00,ARI,26,MIN,34,8,60,0,10,14,177,-199,4,-105,-105,48.5,-106,-106,0,dome,sportturf,,,8,1
2022,REG,8,13:00,LV,0,NO,24,24,24,0,7,10,-119,108,-1,-111,101,48.5,-111,-101,0,dome,sportturf,,,24,1
2022,REG,8,13:00,NE,22,NYJ,17,-5,39,0,6,7,-155,140,-3,-103,-107,40,-102,-110,1,outdoors,fieldturf,,,-5,0
2022,REG,8,13:00,PIT,13,PHI,35,22,48,0,7,14,397,-490,11,102,-112,43,-110,-102,0,outdoors,grass,,,22,1
2022,REG,8,16:05,TEN,17,HOU,10,-7,27,0,7,7,-115,104,-1,-107,-103,39,-102,-110,1,closed,astroturf,,,-7,0
2022,REG,8,16:25,WAS,17,IND,16,-1,33,0,7,7,136,-151,3,-114,103,40.5,-110,-102,0,closed,fieldturf,,,-1,0
2022,REG,8,16:25,SF,31,LA,14,-17,45,0,7,14,-104,-106,-1,103,-114,42,-103,-109,1,dome,matrixturf,,,-17,0
2022,REG,8,16:25,NYG,13,SEA,27,14,40,0,7,7,147,-164,3,-100,-110,44.5,-110,-102,0,outdoors,fieldturf,,,14,1
2022,REG,8,20:20,GB,17,BUF,27,10,44,0,7,14,365,-445,10.5,-110,100,47,-104,-108,0,outdoors,a_turf,,,10,1
2022,REG,8,20:15,CIN,13,CLE,32,19,45,0,8,8,-163,147,-3,-112,102,45,-102,-110,1,outdoors,grass,66,9,19,1
2022,REG,9,20:15,PHI,29,HOU,17,-12,46,0,4,4,-702,539,-14,102,-113,45.5,-112,-101,0,closed,astroturf,,,-12,0
2022,REG,9,13:00,LAC,20,ATL,17,-3,37,0,14,7,-143,130,-2.5,-114,103,49.5,-105,-107,0,open,fieldturf,,,-3,0
2022,REG,9,13:00,MIA,35,CHI,32,-3,67,0,7,7,-193,172,-4,-103,-107,46,-104,-108,0,outdoors,grass,58,17,-3,0
2022,REG,9,13:00,CAR,21,CIN,42,21,63,0,7,6,282,-331,7,-100,-110,43,-114,101,0,outdoors,fieldturf,68,11,21,1
2022,REG,9,13:00,GB,9,DET,15,6,24,0,7,7,-191,170,-4,-107,-103,49.5,-107,-105,1,dome,fieldturf,,,6,1
2022,REG,9,13:00,LV,20,JAX,27,7,47,0,7,7,-129,116,-2.5,-102,-108,47.5,105,-118,0,outdoors,grass,81,14,7,1
2022,REG,9,13:00,IND,3,NE,26,23,29,0,7,7,188,-212,5,-115,104,40,-109,-103,0,outdoors,fieldturf,78,13,23,1
2022,REG,9,13:00,BUF,17,NYJ,20,3,37,0,7,7,-494,400,-11,103,-114,46,-102,-110,1,outdoors,fieldturf,69,17,3,1
2022,REG,9,13:00,MIN,20,WAS,17,-3,37,0,7,7,-169,151,-3,-119,108,43.5,-106,-106,0,outdoors,grass,71,11,-3,0
2022,REG,9,16:05,SEA,31,ARI,21,-10,52,0,7,7,116,-128,1.5,102,-113,49.5,-115,103,1,open,grass,,,-10,0
2022,REG,9,16:25,LA,13,TB,16,3,29,0,7,10,142,-158,3,-104,-106,43,-108,-104,0,outdoors,grass,88,2,3,1
2022,REG,9,20:20,TEN,17,KC,20,3,37,1,7,14,530,-689,14,-107,-103,45,-106,-106,0,outdoors,grass,54,7,3,1
2022,REG,9,20:15,BAL,27,NO,13,-14,40,0,11,8,-124,112,-1,-117,106,46,-108,-104,0,dome,sportturf,,,-14,0
2022,REG,10,20:15,ATL,15,CAR,25,10,40,0,4,4,-132,119,-2.5,-103,-107,41.5,-106,-106,1,outdoors,grass,61,12,10,1
2022,REG,10,9:30,SEA,16,TB,21,5,37,0,7,7,124,-138,2.5,103,-114,45,-104,-108,0,outdoors,,,,5,1
2022,REG,10,13:00,MIN,33,BUF,30,-3,63,1,7,7,230,-264,6.5,-104,-106,47,-105,-107,0,outdoors,a_turf,38,11,-3,0
2022,REG,10,13:00,DET,31,CHI,30,-1,61,0,7,7,143,-159,3,-105,-105,48.5,-114,101,1,outdoors,grass,34,13,-1,0
2022,REG,10,13:00,JAX,17,KC,27,10,44,0,7,7,333,-399,10,-120,109,51.5,-110,-102,0,outdoors,grass,33,7,10,1
2022,REG,10,13:00,CLE,17,MIA,39,22,56,0,13,7,158,-177,3,112,-123,49,-102,-110,0,outdoors,grass,85,7,22,1
2022,REG,10,13:00,HOU,16,NYG,24,8,40,0,10,14,195,-221,5.5,-112,102,41.5,-109,-103,0,outdoors,fieldturf,50,15,8,1
2022,REG,10,13:00,NO,10,PIT,20,10,30,0,6,14,105,-116,1,-103,-107,39.5,-104,-109,0,outdoors,grass,37,15,10,1
2022,REG,10,13:00,DEN,10,TEN,17,7,27,0,14,7,122,-135,2.5,-105,-105,40,-107,-105,0,outdoors,grass,36,9,7,1
2022,REG,10,16:05,IND,25,LV,20,-5,45,0,7,7,177,-199,4.5,-112,101,41,101,-114,0,dome,grass,,,-5,0
2022,REG,10,16:25,DAL,28,GB,31,3,59,1,14,7,-199,177,-3.5,-113,102,44.5,-104,-108,0,outdoors,grass,33,8,3,1
2022,REG,10,16:25,ARI,27,LA,17,-10,44,0,7,7,160,-183,3.5,-110,-102,38,-108,-104,1,dome,matrixturf,,,-10,0
2022,REG,10,20:20,LAC,16,SF,22,6,38,0,7,14,302,-357,8.5,-105,-105,45.5,101,-113,0,outdoors,grass,57,6,6,1
2022,REG,10,20:15,WAS,32,PHI,21,-11,53,0,8,11,405,-501,11,-107,-103,43,-103,-109,1,outdoors,grass,43,6,-11,0
2022,REG,11,20:15,TEN,27,GB,17,-10,44,0,4,4,153,-171,3,106,-117,40.5,-109,-103,0,outdoors,grass,25,11,-10,0
2022,REG,11,13:00,CHI,24,ATL,27,3,51,0,7,10,125,-138,3,-122,110,48.5,-108,-104,0,closed,fieldturf,,,3,1
2022,REG,11,13:00,CAR,3,BAL,13,10,16,0,10,13,503,-647,13,-117,106,42,-112,-100,0,outdoors,grass,36,2,10,1
2022,REG,11,13:00,CLE,23,BUF,31,8,54,0,7,7,298,-353,7.5,-103,-108,50.5,-103,-109,0,dome,fieldturf,,,8,1
2022,REG,11,13:00,WAS,23,HOU,10,-13,33,0,6,7,-150,135,-3,-100,-110,41,-106,-106,0,closed,astroturf,,,-13,0
2022,REG,11,13:00,PHI,17,IND,16,-1,33,0,6,7,-270,235,-6.5,-108,-102,45.5,-103,-109,0,closed,fieldturf,,,-1,0
2022,REG,11,13:00,NYJ,3,NE,10,7,13,0,14,14,163,-182,3.5,-109,-102,38.5,-103,-109,1,outdoors,fieldturf,42,2,7,1
2022,REG,11,13:00,LA,20,NO,27,7,47,0,7,7,112,-124,2.5,-115,104,39.5,-106,-106,0,dome,sportturf,,,7,1
2022,REG,11,13:00,DET,31,NYG,18,-13,49,0,7,7,143,-159,3,-104,-107,44,103,-116,0,outdoors,fieldturf,35,21,-13,0
2022,REG,11,16:05,LV,22,DEN,16,-6,38,1,7,7,131,-145,2.5,106,-117,41.5,-113,100,1,outdoors,grass,49,11,-6,0
2022,REG,11,16:25,DAL,40,MIN,3,-37,43,0,7,7,-131,118,-1.5,-115,104,48.5,-109,-103,0,dome,sportturf,,,-37,0
2022,REG,11,16:25,CIN,37,PIT,30,-7,67,0,14,7,-182,163,-3.5,101,-111,39,100,-112,1,outdoors,grass,27,12,-7,0
2022,REG,11,20:20,KC,30,LAC,27,-3,57,0,7,7,-231,203,-5.5,-102,-108,52.5,-102,-110,1,dome,matrixturf,,,-3,0
2022,REG,11,20:15,SF,38,ARI,10,-28,48,0,8,8,-422,350,-10,103,-113,43.5,-114,101,1,outdoors,,,,-28,0
2022,REG,12,12:30,BUF,28,DET,25,-3,53,0,4,4,-412,342,-10,105,-116,54,-102,-110,0,dome,fieldturf,,,-3,0
2022,REG,12,16:30,NYG,20,DAL,28,8,48,0,4,4,363,-441,10.5,-114,104,45.5,-106,-106,1,closed,matrixturf,,,8,1
2022,REG,12,20:20,NE,26,MIN,33,7,59,0,4,4,123,-136,2.5,-102,-108,42.5,-106,-106,0,dome,sportturf,,,7,1
2022,REG,12,13:00,DEN,10,CAR,23,13,33,0,7,7,-116,105,-1,-109,-101,36.5,-111,-101,0,outdoors,grass,66,15,13,1
2022,REG,12,13:00,TB,17,CLE,23,6,40,1,14,7,-169,151,-3,-118,107,42,-103,-109,0,outdoors,grass,56,14,6,1
2022,REG,12,13:00,BAL,27,JAX,28,1,55,0,7,14,-164,147,-3.5,111,-123,43,-102,-111,0,outdoors,grass,77,19,1,1
2022,REG,12,13:00,HOU,15,MIA,30,15,45,0,7,14,613,-822,14,-101,-109,47,-103,-109,0,outdoors,grass,84,13,15,1
2022,REG,12,13:00,CHI,10,NYJ,31,21,41,0,7,7,315,-375,8.5,-107,-103,36.5,-103,-109,0,outdoors,fieldturf,50,9,21,1
2022,REG,12,13:00,CIN,20,TEN,16,-4,36,0,7,10,-105,-105,-1,102,-113,43,-118,105,0,outdoors,grass,56,14,-4,0
2022,REG,12,13:00,ATL,13,WAS,19,6,32,0,7,7,163,-183,3.5,-110,-100,40.5,-114,101,0,outdoors,grass,46,9,6,1
2022,REG,12,16:05,LAC,25,ARI,24,-1,49,0,7,6,-136,123,-2.5,-108,-102,48.5,-100,-112,0,closed,grass,,,-1,0
2022,REG,12,16:05,LV,40,SEA,34,-6,74,1,7,14,174,-196,4,-107,-103,47.5,-103,-109,0,outdoors,fieldturf,44,8,-6,0
2022,REG,12,16:25,LA,10,KC,26,16,36,0,7,7,768,-1088,16.5,-115,105,42,-108,-104,0,outdoors,grass,44,6,16,1
2022,REG,12,16:25,NO,0,SF,13,13,13,0,7,6,327,-392,9.5,-113,103,44,-116,103,0,outdoors,grass,59,2,13,1
2022,REG,12,20:20,GB,33,PHI,40,7,73,0,10,7,241,-278,6.5,-105,-105,46,-106,-106,0,outdoors,grass,62,24,7,1
2022,REG,12,20:15,PIT,24,IND,17,-7,41,0,8,8,116,-128,2.5,-110,-100,40,-114,101,0,closed,fieldturf,,,-7,0
2022,REG,13,20:15,BUF,24,NE,10,-14,34,0,7,7,-185,165,-3.5,-105,-105,43.5,-103,-109,1,outdoors,fieldturf,35,2,-14,0
2022,REG,13,13:00,PIT,19,ATL,16,-3,35,0,6,7,-113,103,-1,-105,-105,43,-108,-104,0,closed,fieldturf,,,-3,0
2022,REG,13,13:00,DEN,9,BAL,10,1,19,0,7,7,294,-347,9.5,-124,112,40.5,100,-113,0,outdoors,grass,63,8,1,1
2022,REG,13,13:00,GB,28,CHI,19,-9,47,0,7,7,-182,163,-4,105,-116,45,-114,101,1,outdoors,grass,38,12,-9,0
2022,REG,13,13:00,JAX,14,DET,40,26,54,0,7,10,107,-118,1,-100,-110,51.5,-114,101,0,dome,fieldturf,,,26,1
2022,REG,13,13:00,CLE,27,HOU,14,-13,41,0,7,7,-329,280,-7.5,-108,-102,47,-119,106,0,closed,astroturf,,,-13,0
2022,REG,13,13:00,NYJ,22,MIN,27,5,49,0,7,10,132,-146,3,-117,106,44,-108,-104,0,dome,sportturf,,,5,1
2022,REG,13,13:00,WAS,20,NYG,20,0,40,1,7,10,-124,113,-2.5,105,-116,40,-104,-108,1,outdoors,fieldturf,40,9,0,1
2022,REG,13,13:00,TEN,10,PHI,35,25,45,0,7,7,189,-213,5,-109,-101,44.5,101,-114,0,outdoors,grass,60,7,25,1
2022,REG,13,16:05,SEA,27,LA,23,-4,50,0,7,7,-292,252,-7,107,-118,41,101,-114,1,dome,matrixturf,,,-4,0
2022,REG,13,16:05,MIA,17,SF,33,16,50,0,7,7,196,-222,4.5,101,-111,46,-110,-102,0,outdoors,grass,38,6,16,1
2022,REG,13,16:25,KC,24,CIN,27,3,51,0,7,7,-132,120,-2.5,-108,-102,53,-107,-105,0,outdoors,fieldturf,57,2,3,1
2022,REG,13,16:25,LAC,20,LV,27,7,47,0,7,7,125,-139,2.5,-102,-109,49,102,-114,1,dome,grass,,,7,1
2022,REG,13,20:20,IND,19,DAL,54,35,73,0,6,10,376,-460,11,-109,-101,44.5,-104,-108,0,closed,matrixturf,,,35,1
2022,REG,13,20:15,NO,16,TB,17,1,33,0,8,8,169,-190,3.5,-105,-105,41,-107,-105,1,outdoors,grass,69,2,1,1
2022,REG,14,20:15,LV,16,LA,17,1,33,0,4,4,-283,245,-6.5,-112,101,42.5,-115,102,0,dome,matrixturf,,,1,1
2022,REG,14,13:00,NYJ,12,BUF,20,8,32,0,7,10,332,-398,10,-108,-102,43.5,-104,-108,1,outdoors,a_turf,36,11,8,1
2022,REG,14,13:00,CLE,10,CIN,23,13,33,0,7,7,181,-204,4.5,-108,-102,47,-108,-105,1,outdoors,fieldturf,47,8,13,1
2022,REG,14,13:00,HOU,23,DAL,27,4,50,0,7,7,918,-1365,17,104,-115,44.5,-108,-104,0,closed,matrixturf,,,4,1
2022,REG,14,13:00,MIN,23,DET,34,11,57,0,7,7,119,-132,2.5,-108,-102,51.5,-110,-102,1,dome,fieldturf,,,11,1
2022,REG,14,13:00,PHI,48,NYG,22,-26,70,0,7,7,-302,260,-7.5,104,-115,44.5,-109,-103,1,outdoors,fieldturf,37,6,-26,0
2022,REG,14,13:00,BAL,16,PIT,14,-2,30,0,7,7,112,-124,1.5,-101,-109,37,-114,101,1,outdoors,grass,42,12,-2,0
2022,REG,14,13:00,JAX,36,TEN,22,-14,58,0,7,7,151,-169,3,106,-117,42,-112,-101,1,outdoors,grass,54,8,-14,0
2022,REG,14,16:05,KC,34,DEN,28,-6,62,0,7,7,-394,329,-8.5,-108,-103,44.5,-112,-100,1,outdoors,grass,55,4,-6,0
2022,REG,14,16:25,CAR,30,SEA,24,-6,54,0,14,7,178,-200,3.5,106,-117,44.5,-109,-104,0,outdoors,fieldturf,45,4,-6,0
2022,REG,14,16:25,TB,7,SF,35,28,42,0,6,7,175,-196,3.5,-107,-103,38,104,-117,0,outdoors,grass,54,8,28,1
2022,REG,14,20:20,MIA,17,LAC,23,6,40,0,7,7,-163,146,-3,-113,102,54.5,-102,-110,0,dome,matrixturf,,,6,1
2022,REG,14,20:15,NE,27,ARI,13,-14,40,0,11,15,-125,113,-2,-104,-106,44,-103,-110,0,closed,grass,,,-14,0
2022,REG,15,20:15,SF,21,SEA,13,-8,34,0,4,4,-169,152,-3,-115,104,43,-109,-103,1,outdoors,fieldturf,,,-8,0
2022,REG,15,13:00,IND,36,MIN,39,3,75,1,13,6,168,-188,3.5,-103,-107,46.5,-107,-105,0,dome,sportturf,,,3,1
2022,REG,15,16:30,BAL,3,CLE,13,10,16,0,6,6,139,-155,2.5,113,-125,39.5,-107,-105,1,outdoors,grass,34,12,10,1
2022,REG,15,20:15,MIA,29,BUF,32,3,61,0,6,6,273,-320,7,-104,-106,44,106,-119,1,outdoors,a_turf,29,4,3,1
2022,REG,15,13:00,PIT,24,CAR,16,-8,40,0,7,7,130,-145,2.5,-100,-110,36.5,101,-114,0,outdoors,grass,47,7,-8,0
2022,REG,15,13:00,PHI,25,CHI,20,-5,45,0,7,14,-386,323,-8.5,-104,-106,48,-110,-103,0,outdoors,grass,17,17,-5,0
2022,REG,15,13:00,KC,30,HOU,24,-6,54,1,7,7,-755,572,-14.5,109,-120,48.5,-109,-103,0,closed,astroturf,,,-6,0
2022,REG,15,13:00,DAL,34,JAX,40,6,74,1,7,7,-188,168,-4,100,-110,48.5,-103,-110,0,outdoors,grass,54,9,6,1
2022,REG,15,13:00,ATL,18,NO,21,3,39,0,14,13,203,-231,5,103,-113,43.5,-109,-103,1,dome,sportturf,,,3,1
2022,REG,15,13:00,DET,20,NYJ,17,-3,37,0,7,7,120,-132,2,-100,-110,44,-109,-103,0,outdoors,fieldturf,38,13,-3,0
2022,REG,15,16:05,ARI,15,DEN,24,9,39,0,6,7,110,-121,1.5,-104,-106,37.5,-110,-103,0,outdoors,grass,37,4,9,1
2022,REG,15,16:05,NE,24,LV,30,6,54,0,6,10,117,-129,1,111,-122,45,-105,-108,0,dome,grass,,,6,1
2022,REG,15,16:25,TEN,14,LAC,17,3,31,0,7,7,142,-158,3,-108,-102,46.5,-101,-112,0,dome,matrixturf,,,3,1
2022,REG,15,16:25,CIN,34,TB,23,-11,57,0,7,7,-167,150,-3.5,108,-120,47,101,-114,0,outdoors,grass,66,6,-11,0
2022,REG,15,20:20,NYG,20,WAS,12,-8,32,0,7,14,180,-203,4.5,-114,103,40.5,-104,-108,1,outdoors,grass,35,13,-8,0
2022,REG,15,20:15,LA,12,GB,24,12,36,0,11,15,301,-356,8,-111,101,39.5,-101,-111,0,outdoors,grass,15,4,12,1
2022,REG,16,20:15,JAX,19,NYJ,3,-16,22,0,4,4,123,-136,2.5,-104,-106,36.5,-106,-106,0,outdoors,fieldturf,43,17,-16,0
2022,REG,16,13:00,ATL,9,BAL,17,8,26,0,6,7,238,-274,6.5,-108,-102,35,-105,-107,0,outdoors,grass,17,9,8,1
2022,REG,16,13:00,DET,23,CAR,37,14,60,0,6,6,-129,117,-2.5,101,-111,43.5,-112,-100,0,outdoors,grass,20,12,14,1
2022,REG,16,13:00,BUF,35,CHI,13,-22,48,0,7,6,-360,304,-8,-110,-100,40,102,-115,0,outdoors,grass,7,17,-22,0
2022,REG,16,13:00,NO,17,CLE,10,-7,27,0,6,7,162,-181,3,111,-123,32,-108,-104,0,outdoors,grass,6,27,-7,0
2022,REG,16,13:00,SEA,10,KC,24,14,34,0,9,6,367,-447,10.5,-107,-103,50.5,-105,-107,0,outdoors,grass,12,9,14,1
2022,REG,16,13:00,NYG,24,MIN,27,3,51,0,6,7,191,-215,4.5,-102,-108,48,-109,-104,0,dome,sportturf,,,3,1
2022,REG,16,13:00,CIN,22,NE,18,-4,40,0,6,6,-151,136,-3,100,-110,42,-109,-103,0,outdoors,fieldturf,21,2,-4,0
2022,REG,16,14:00,HOU,19,TEN,14,-5,33,0,6,6,153,-170,3,103,-113,34,-111,-101,1,outdoors,grass,22,14,-5,0
2022,REG,16,16:05,WAS,20,SF,37,17,57,0,6,9,241,-279,6.5,-107,-103,37.5,-114,102,0,outdoors,grass,54,2,17,1
2022,REG,16,16:25,PHI,34,DAL,40,6,74,0,6,6,178,-200,4,-104,-106,48,-112,-101,1,closed,matrixturf,,,6,1
2022,REG,16,20:15,LV,10,PIT,13,3,23,0,6,6,127,-141,2.5,-108,-102,38.5,-110,-102,0,outdoors,grass,9,21,3,1
2022,REG,16,13:00,GB,26,MIA,20,-6,46,0,6,8,163,-182,3.5,-107,-103,49,-103,-109,0,outdoors,grass,45,14,-6,0
2022,REG,16,16:30,DEN,14,LA,51,37,65,0,7,6,-173,155,-3,-116,105,36.5,-109,-103,0,dome,matrixturf,,,37,1
2022,REG,16,20:20,TB,19,ARI,16,-3,35,1,7,7,-320,273,-7.5,102,-113,41.5,-104,-108,0,open,grass,,,-3,0
2022,REG,16,20:15,LAC,20,IND,3,-17,23,0,8,9,-185,165,-3.5,-102,-108,44.5,-103,-109,0,closed,fieldturf,,,-17,0
2022,REG,17,20:15,DAL,27,TEN,13,-14,40,0,5,5,-741,563,-14,-100,-110,41,-113,101,0,outdoors,grass,56,4,-14,0
2022,REG,17,13:00,ARI,19,ATL,20,1,39,0,7,8,241,-279,7,-119,108,41,-113,100,0,closed,fieldturf,,,1,1
2022,REG,17,13:00,CHI,10,DET,41,31,51,0,8,8,194,-219,4.5,-105,-105,52.5,-111,-101,1,dome,fieldturf,,,31,1
2022,REG,17,13:00,JAX,31,HOU,3,-28,34,0,10,8,-187,167,-3.5,-104,-106,43,102,-115,1,closed,astroturf,,,-28,0
2022,REG,17,13:00,DEN,24,KC,27,3,51,0,7,8,544,-711,13.5,-114,104,46,-104,-108,1,outdoors,grass,47,2,3,1
2022,REG,17,13:00,MIA,21,NE,23,2,44,0,7,8,144,-160,3,-106,-104,41.5,-107,-105,1,outdoors,fieldturf,53,2,2,1
2022,REG,17,13:00,IND,10,NYG,38,28,48,0,6,8,202,-229,5.5,-105,-105,38.5,-103,-109,0,outdoors,fieldturf,52,14,28,1
2022,REG,17,13:00,NO,20,PHI,10,-10,30,0,8,8,198,-225,5.5,-110,-100,41.5,101,-113,0,outdoors,grass,54,11,-10,0
2022,REG,17,13:00,CAR,24,TB,30,6,54,0,8,7,164,-184,3.5,-110,-100,40.5,-103,-109,1,outdoors,grass,75,2,6,1
2022,REG,17,13:00,CLE,24,WAS,10,-14,34,0,8,8,106,-117,1,-101,-110,41.5,-109,-103,0,outdoors,grass,59,9,-14,0
2022,REG,17,16:05,SF,37,LV,34,-3,71,1,8,8,-453,371,-10,-103,-107,41.5,-107,-105,0,dome,grass,,,-3,0
2022,REG,17,16:05,NYJ,6,SEA,23,17,29,0,10,8,-113,102,-1,-105,-105,43,-103,-109,0,outdoors,fieldturf,45,2,17,1
2022,REG,17,16:25,MIN,17,GB,41,24,58,0,8,7,155,-173,3,106,-117,47.5,-103,-109,1,outdoors,grass,39,7,24,1
2022,REG,17,16:25,LA,10,LAC,31,21,41,0,7,6,244,-283,6.5,-102,-108,41.5,-112,-100,0,dome,matrixturf,,,21,1
2022,REG,17,20:20,PIT,16,BAL,13,-3,29,0,8,8,110,-121,1,102,-113,35.5,-105,-107,1,outdoors,grass,44,2,-3,0
2022,REG,18,16:30,KC,31,LV,13,-18,44,0,6,6,-407,338,-9,-105,-105,51.5,-108,-104,1,dome,grass,,,-18,0
2022,REG,18,20:15,TEN,16,JAX,20,4,36,0,9,6,227,-260,6,-106,-104,39.5,-106,-106,1,outdoors,grass,56,4,4,1
2022,REG,18,13:00,TB,17,ATL,30,13,47,0,7,7,207,-235,6,-110,100,40.5,-106,-106,1,closed,fieldturf,,,13,1
2022,REG,18,13:00,NE,23,BUF,35,12,58,0,7,6,314,-373,8,104,-115,44,-104,-108,1,outdoors,a_turf,30,6,12,1
2022,REG,18,13:00,MIN,29,CHI,13,-16,42,0,7,7,-260,227,-6.5,-104,-106,42.5,-103,-109,1,outdoors,grass,32,2,-16,0
2022,REG,18,13:00,BAL,16,CIN,27,11,43,0,7,6,474,-603,11,105,-116,39,-102,-110,1,outdoors,fieldturf,38,7,11,1
2022,REG,18,13:00,HOU,32,IND,31,-1,63,0,7,7,128,-142,3,-119,108,38,-111,-101,1,closed,fieldturf,,,-1,0
2022,REG,18,13:00,NYJ,6,MIA,11,5,17,0,7,7,178,-200,3.5,-103,-107,37.5,-110,-103,1,outdoors,grass,75,9,5,1
2022,REG,18,13:00,CAR,10,NO,7,-3,17,0,7,7,160,-179,3.5,-114,103,41.5,-107,-105,1,dome,sportturf,,,-3,0
2022,REG,18,13:00,CLE,14,PIT,28,14,42,0,7,7,128,-142,2.5,-101,-109,40,-106,-106,1,outdoors,grass,36,8,14,1
2022,REG,18,16:25,LAC,28,DEN,31,3,59,0,7,7,222,-254,6,-104,-106,38.5,-103,-110,1,outdoors,grass,43,4,3,1
2022,REG,18,16:25,NYG,16,PHI,22,6,38,0,7,7,858,-1252,16.5,-103,-107,42.5,-105,-107,1,outdoors,grass,43,12,6,1
2022,REG,18,16:25,LA,16,SEA,19,3,35,1,7,7,198,-224,5.5,-112,102,41.5,-101,-111,1,outdoors,fieldturf,45,4,3,1
2022,REG,18,16:25,ARI,13,SF,38,25,51,0,7,7,753,-1061,14,100,-111,40,-107,-105,1,outdoors,grass,57,2,25,1
2022,REG,18,16:25,DAL,6,WAS,26,20,32,0,10,7,-320,274,-7.5,-100,-110,40.5,-104,-108,1,outdoors,grass,42,7,20,1
2022,REG,18,20:20,DET,20,GB,16,-4,36,0,7,7,237,-273,5.5,-110,-100,49,-113,101,1,outdoors,grass,21,4,-4,0
2023,REG,1,20:20,DET,21,KC,20,-1,41,0,7,7,164,-198,4,-110,-110,53,-110,-110,0,outdoors,,,,-1,0
2023,REG,1,13:00,CAR,10,ATL,24,14,34,0,7,7,160,-192,3.5,-108,-112,40.5,-110,-110,1,closed,,,,14,1
2023,REG,1,13:00,HOU,9,BAL,25,16,34,0,7,7,380,-500,9.5,-110,-110,43.5,-110,-110,0,outdoors,,,,16,1
2023,REG,1,13:00,CIN,3,CLE,24,21,27,0,7,7,-112,-108,-1,-105,-115,46.5,-110,-110,1,outdoors,,,,21,1
2023,REG,1,13:00,JAX,31,IND,21,-10,52,0,7,7,-205,170,-4,-108,-112,45.5,-110,-110,1,closed,,,,-10,0
2023,REG,1,13:00,TB,20,MIN,17,-3,37,0,7,7,170,-205,4,-110,-110,45,-110,-110,0,dome,,,,-3,0
2023,REG,1,13:00,TEN,15,NO,16,1,31,0,7,7,124,-148,3,-118,-102,41,-110,-110,0,dome,,,,1,1
2023,REG,1,13:00,SF,30,PIT,7,-23,37,0,7,7,-120,100,-1.5,-108,-112,41.5,-110,-110,0,outdoors,,,,-23,0
2023,REG,1,13:00,ARI,16,WAS,20,4,36,0,7,7,270,-340,7,-108,-112,38,-110,-110,0,outdoors,,,,4,1
2023,REG,1,16:25,GB,38,CHI,20,-18,58,0,7,7,-102,-118,1,-110,-110,41,-112,-108,1,outdoors,,,,-18,0
2023,REG,1,16:25,LV,17,DEN,16,-1,33,0,7,7,136,-162,3,-105,-115,43,-110,-110,1,outdoors,,,,-1,0
2023,REG,1,16:25,MIA,36,LAC,34,-2,70,0,7,7,136,-162,3,-110,-110,50.5,-110,-110,0,dome,,,,-2,0
2023,REG,1,16:25,PHI,25,NE,20,-5,45,0,7,7,-185,154,-3.5,-110,-110,44.5,-112,-108,0,outdoors,,,,-5,0
2023,REG,1,16:25,LA,30,SEA,13,-17,43,0,7,7,180,-218,4.5,-110,-110,45,-110,-110,1,outdoors,,,,-17,0
2023,REG,1,20:20,DAL,40,NYG,0,-40,40,0,7,7,-170,142,-3.5,100,-120,44.5,-110,-110,1,outdoors,,,,-40,0
2023,REG,1,20:15,BUF,16,NYJ,22,6,38,1,7,7,-135,114,-2.5,-110,-110,44.5,-110,-110,1,outdoors,,,,6,1
2023,REG,2,20:15,MIN,28,PHI,34,6,62,0,4,4,195,-238,6,-110,-110,49,-110,-110,0,outdoors,,,,6,1
2023,REG,2,13:00,GB,24,ATL,25,1,49,0,7,7,124,-148,3,-115,-105,40.5,-110,-110,0,open,,,,1,1
2023,REG,2,13:00,LV,10,BUF,38,28,48,0,7,6,280,-355,7.5,-110,-110,47,-110,-110,0,outdoors,,,,28,1
2023,REG,2,13:00,BAL,27,CIN,24,-3,51,0,7,7,145,-175,3.5,-118,-102,45.5,-110,-110,1,outdoors,,,,-3,0
2023,REG,2,13:00,SEA,37,DET,31,-6,68,1,7,10,180,-218,4.5,-110,-110,47.5,-108,-112,0,dome,,,,-6,0
2023,REG,2,13:00,IND,31,HOU,20,-11,51,0,7,7,-110,-110,-1,-105,-115,40,-110,-110,1,open,,,,-11,0
2023,REG,2,13:00,KC,17,JAX,9,-8,26,0,10,7,-170,142,-3.5,-102,-118,50.5,-110,-110,0,outdoors,,,,-8,0
2023,REG,2,13:00,CHI,17,TB,27,10,44,0,7,7,114,-135,2.5,-110,-110,41,-110,-110,0,outdoors,,,,10,1
2023,REG,2,13:00,LAC,24,TEN,27,3,51,1,7,7,-142,120,-2.5,-118,-102,45.5,-110,-110,0,outdoors,,,,3,1
2023,REG,2,16:05,NYG,31,ARI,28,-3,59,0,7,7,-225,185,-5,-110,-110,40,-110,-110,0,closed,,,,-3,0
2023,REG,2,16:05,SF,30,LA,23,-7,53,0,7,7,-340,270,-7.5,-105,-115,45,-110,-110,1,dome,,,,-7,0
2023,REG,2,16:25,NYJ,10,DAL,30,20,40,0,6,7,300,-380,8.5,-110,-110,38.5,-110,-110,0,open,,,,20,1
2023,REG,2,16:25,WAS,35,DEN,33,-2,68,0,7,7,164,-198,4,-110,-110,38.5,-110,-110,0,outdoors,,,,-2,0
2023,REG,2,20:20,MIA,24,NE,17,-7,41,0,7,7,-130,110,-2,-112,-108,46.5,-112,-108,1,outdoors,,,,-7,0
2023,REG,2,19:15,NO,20,CAR,17,-3,37,0,8,8,-175,145,-3,-118,-102,39.5,-108,-112,1,outdoors,,,,-3,0
2023,REG,2,20:15,CLE,22,PIT,26,4,48,0,8,8,-148,124,-2.5,-115,-105,39,-110,-110,1,outdoors,,,,4,1
2023,REG,3,20:15,NYG,12,SF,30,18,42,0,4,4,400,-535,10.5,-105,-115,43.5,-108,-112,0,outdoors,grass,77,13,18,1
2023,REG,3,13:00,IND,22,BAL,19,-3,41,1,7,7,300,-380,7.5,-110,-110,43.5,-110,-110,0,outdoors,grass,68,3,-3,0
2023,REG,3,13:00,TEN,3,CLE,27,24,30,0,7,6,154,-185,3.5,-110,-110,38,-110,-110,0,outdoors,grass,68,5,24,1
2023,REG,3,13:00,ATL,6,DET,20,14,26,0,7,7,140,-166,3,100,-120,47.5,-108,-112,0,dome,fieldturf,,,14,1
2023,REG,3,13:00,NO,17,GB,18,1,35,0,6,7,-125,105,-1.5,-110,-110,41.5,-110,-110,0,outdoors,grass,68,10,1,1
2023,REG,3,13:00,HOU,37,JAX,17,-20,54,0,7,7,300,-380,7.5,-110,-110,43.5,-110,-110,1,outdoors,grass,84,6,-20,0
2023,REG,3,13:00,DEN,20,MIA,70,50,90,0,7,7,205,-250,6,-110,-110,47.5,-110,-110,0,outdoors,grass,86,5,50,1
2023,REG,3,13:00,LAC,28,MIN,24,-4,52,0,7,10,-110,-110,1,-115,-105,54,-110,-110,0,dome,sportturf,,,-4,0
2023,REG,3,13:00,NE,15,NYJ,10,-5,25,0,7,7,-142,120,-2.5,-112,-108,35.5,-110,-110,1,outdoors,fieldturf,64,14,-5,0
2023,REG,3,13:00,BUF,37,WAS,3,-34,40,0,7,7,-245,200,-5.5,-115,-105,44,-108,-112,0,outdoors,grass,65,1,-34,0
2023,REG,3,16:05,CAR,27,SEA,37,10,64,0,6,7,185,-225,5,-110,-110,42.5,-110,-110,0,outdoors,fieldturf,61,2,10,1
2023,REG,3,16:25,DAL,16,ARI,28,12,44,0,7,7,-650,470,-11.5,-110,-110,43.5,-110,-110,0,open,grass,,,12,1
2023,REG,3,16:25,CHI,10,KC,41,31,51,0,7,7,525,-750,13,-110,-110,48,-110,-110,0,outdoors,grass,,,31,1
2023,REG,3,20:20,PIT,23,LV,18,-5,41,0,6,7,124,-148,3,-110,-110,43.5,-110,-110,0,dome,grass,,,-5,0
2023,REG,3,19:15,PHI,25,TB,11,-14,36,0,11,8,-258,210,-6,-110,-110,44,-108,-112,0,outdoors,grass,90,4,-14,0
2023,REG,3,20:15,LA,16,CIN,19,3,35,0,8,8,136,-162,3,100,-120,45.5,-108,-112,0,outdoors,fieldturf,74,7,3,1
2023,REG,4,20:15,DET,34,GB,20,-14,54,0,4,4,-142,120,-2.5,-118,-102,45,-110,-110,1,outdoors,grass,64,8,-14,0
2023,REG,4,9:30,ATL,7,JAX,23,16,30,0,7,7,154,-185,3.5,-110,-110,42.5,-112,-108,0,outdoors,,,,16,1
2023,REG,4,13:00,MIA,20,BUF,48,28,68,0,7,7,120,-142,2.5,100,-120,53,-110,-110,1,outdoors,a_turf,70,2,28,1
2023,REG,4,13:00,MIN,21,CAR,13,-8,34,0,7,7,-225,185,-4.5,-112,-108,46.5,-110,-110,0,outdoors,grass,78,7,-8,0
2023,REG,4,13:00,DEN,31,CHI,28,-3,59,0,7,7,-162,136,-3,-112,-108,47,-110,-110,0,outdoors,grass,80,2,-3,0
2023,REG,4,13:00,BAL,28,CLE,3,-25,31,0,7,7,-135,114,-2,-110,-110,38.5,-110,-110,1,outdoors,grass,71,7,-25,0
2023,REG,4,13:00,PIT,6,HOU,30,24,36,0,7,7,-162,136,-3,-110,-110,41.5,-110,-110,0,open,astroturf,,,24,1
2023,REG,4,13:00,LA,29,IND,23,-6,52,1,6,7,-115,-105,-1,-110,-110,44.5,-110,-110,0,open,fieldturf,,,-6,0
2023,REG,4,13:00,TB,26,NO,9,-17,35,0,6,7,170,-205,4,-110,-110,41,-110,-110,1,dome,sportturf,,,-17,0
2023,REG,4,13:00,WAS,31,PHI,34,3,65,1,7,6,350,-455,9.5,-110,-110,43,-110,-110,1,outdoors,grass,,,3,1
2023,REG,4,13:00,CIN,3,TEN,27,24,30,0,6,7,-162,136,-2.5,-120,100,41.5,-108,-112,0,outdoors,grass,82,4,24,1
2023,REG,4,16:05,LV,17,LAC,24,7,41,0,7,7,250,-310,7,-115,-105,49,-110,-110,1,dome,matrixturf,,,7,1
2023,REG,4,16:25,NE,3,DAL,38,35,41,0,7,7,230,-285,6.5,-108,-112,43,-110,-110,0,closed,matrixturf,,,35,1
2023,REG,4,16:25,ARI,16,SF,35,19,51,0,7,10,700,-1100,15,-108,-112,44,-105,-115,1,outdoors,grass,75,9,19,1
2023,REG,4,20:20,KC,23,NYJ,20,-3,43,0,7,7,-485,370,-9.5,-110,-110,41.5,-105,-115,0,outdoors,fieldturf,69,5,-3,0
2023,REG,4,20:15,SEA,24,NYG,3,-21,27,0,8,11,-142,120,-2.5,-115,-105,46.5,-115,-105,0,outdoors,fieldturf,67,8,-21,0
2023,REG,5,20:15,CHI,40,WAS,20,-20,60,0,4,4,210,-258,6,-110,-110,45.5,-112,-108,0,outdoors,grass,70,1,-20,0
2023,REG,5,9:30,JAX,25,BUF,20,-5,45,0,7,7,205,-250,5.5,-110,-110,48.5,-108,-112,0,outdoors,,,,-5,0
2023,REG,5,13:00,HOU,19,ATL,21,2,40,0,7,7,120,-142,2.5,-110,-110,42,-110,-110,0,open,fieldturf,,,2,1
2023,REG,5,13:00,CAR,24,DET,42,18,66,0,7,10,350,-455,9.5,-110,-110,43.5,-110,-110,0,dome,fieldturf,,,18,1
2023,REG,5,13:00,TEN,16,IND,23,7,39,0,7,7,-142,120,-2.5,-110,-110,43.5,-110,-110,1,open,fieldturf,,,7,1
2023,REG,5,13:00,NYG,16,MIA,31,15,47,0,6,7,525,-750,12.5,-110,-110,47.5,-108,-112,0,outdoors,grass,88,8,15,1
2023,REG,5,13:00,NO,34,NE,0,-34,34,0,7,7,114,-135,2.5,-110,-110,38.5,-110,-110,0,outdoors,fieldturf,61,10,-34,0
2023,REG,5,13:00,BAL,10,PIT,17,7,27,0,7,7,-230,190,-4.5,-112,-108,38.5,-110,-110,1,outdoors,grass,53,13,7,1
2023,REG,5,16:05,CIN,34,ARI,20,-14,54,0,7,7,-170,142,-3,-120,100,45.5,-110,-110,0,closed,grass,,,-14,0
2023,REG,5,16:05,PHI,23,LA,14,-9,37,0,7,7,-192,160,-3.5,-110,-110,50.5,-110,-110,0,dome,matrixturf,,,-9,0
2023,REG,5,16:25,NYJ,31,DEN,21,-10,52,0,7,7,114,-135,2.5,-110,-110,42.5,-110,-110,0,outdoors,grass,73,9,-10,0
2023,REG,5,16:25,KC,27,MIN,20,-7,47,0,7,7,-180,150,-3.5,-105,-115,52.5,-110,-110,0,dome,sportturf,,,-7,0
2023,REG,5,20:20,DAL,10,SF,42,32,52,0,7,7,150,-180,3.5,-115,-105,45,-105,-115,0,outdoors,grass,78,10,32,1
2023,REG,5,20:15,GB,13,LV,17,4,30,0,11,8,-102,-118,1,-110,-110,45,-110,-110,0,dome,grass,,,4,1
2023,REG,6,20:15,DEN,8,KC,19,11,27,0,4,4,470,-650,10.5,-108,-112,47.5,-112,-108,1,outdoors,grass,,,11,1
2023,REG,6,9:30,BAL,24,TEN,16,-8,40,0,7,7,-250,205,-5.5,-112,-108,42.5,-110,-110,0,outdoors,,,,-8,0
2023,REG,6,13:00,WAS,24,ATL,16,-8,40,0,10,7,105,-125,1.5,-108,-112,42,-110,-110,0,closed,fieldturf,,,-8,0
2023,REG,6,13:00,MIN,19,CHI,13,-6,32,0,7,10,-166,140,-3,-115,-105,44.5,-112,-108,1,outdoors,grass,53,16,-6,0
2023,REG,6,13:00,SEA,13,CIN,17,4,30,0,13,7,130,-155,3,-112,-108,45.5,-108,-112,0,outdoors,fieldturf,57,15,4,1
2023,REG,6,13:00,SF,17,CLE,19,2,36,0,7,14,-470,360,-9.5,-115,-105,36,-110,-110,0,outdoors,grass,53,15,2,1
2023,REG,6,13:00,NO,13,HOU,20,7,33,0,7,7,-130,110,-2,-110,-110,42.5,-112,-108,0,closed,astroturf,,,7,1
2023,REG,6,13:00,IND,20,JAX,37,17,57,0,7,7,170,-205,4,-110,-110,44,-110,-110,1,outdoors,grass,,,17,1
2023,REG,6,13:00,CAR,21,MIA,42,21,63,0,7,7,700,-1100,14,-110,-110,47.5,-112,-108,0,outdoors,grass,87,12,21,1
2023,REG,6,16:05,NE,17,LV,21,4,38,0,7,6,124,-148,3,-118,-102,41.5,-110,-110,0,dome,grass,,,4,1
2023,REG,6,16:25,ARI,9,LA,26,17,35,0,7,7,270,-340,7,-105,-115,48,-110,-110,1,dome,matrixturf,,,17,1
2023,REG,6,16:25,PHI,14,NYJ,20,6,34,0,7,7,-305,245,-6.5,-115,-105,43,-105,-115,0,outdoors,fieldturf,59,11,6,1
2023,REG,6,16:25,DET,20,TB,6,-14,26,0,7,14,-162,136,-3,-115,-105,43.5,-112,-108,0,outdoors,grass,77,13,-14,0
2023,REG,6,20:20,NYG,9,BUF,14,5,23,0,7,7,750,-1200,15.5,-110,-110,43.5,-110,-110,0,outdoors,a_turf,46,7,5,1
2023,REG,6,20:15,DAL,20,LAC,17,-3,37,0,8,15,-130,110,-1.5,-112,-108,49.5,-108,-112,0,dome,matrixturf,,,-3,0
2023,REG,7,20:15,JAX,31,NO,24,-7,55,0,4,4,124,-148,2.5,-108,-112,41,-110,-110,0,dome,sportturf,,,-7,0
2023,REG,7,13:00,DET,6,BAL,38,32,44,0,7,7,136,-162,3,-105,-115,43.5,-108,-112,0,outdoors,grass,62,16,32,1
2023,REG,7,13:00,LV,12,CHI,30,18,42,0,7,7,-142,120,-2.5,-110,-110,38.5,-110,-110,0,outdoors,grass,52,8,18,1
2023,REG,7,13:00,CLE,39,IND,38,-1,77,0,7,7,-180,150,-3.5,-108,-112,40,-110,-110,0,open,fieldturf,,,-1,0
2023,REG,7,13:00,BUF,25,NE,29,4,54,0,7,7,-395,310,-7.5,-110,-110,41,-110,-110,1,outdoors,fieldturf,55,13,4,1
2023,REG,7,13:00,WAS,7,NYG,14,7,21,0,7,7,-162,136,-3,-108,-112,37,-112,-108,1,outdoors,fieldturf,54,14,7,1
2023,REG,7,13:00,ATL,16,TB,13,-3,29,0,7,7,124,-148,3,-115,-105,37.5,-115,-105,1,outdoors,grass,79,3,-3,0
2023,REG,7,16:05,PIT,24,LA,17,-7,41,0,14,7,145,-175,3.5,-118,-102,44,-112,-108,0,dome,matrixturf,,,-7,0
2023,REG,7,16:05,ARI,10,SEA,20,10,30,0,7,7,350,-455,9.5,-112,-108,43.5,-110,-110,1,outdoors,fieldturf,56,5,10,1
2023,REG,7,16:25,GB,17,DEN,19,2,36,0,13,10,-102,-118,1.5,-112,-108,44,-110,-110,0,outdoors,grass,72,9,2,1
2023,REG,7,16:25,LAC,17,KC,31,14,48,0,6,10,215,-265,5.5,-105,-115,48.5,-108,-112,1,outdoors,grass,72,10,14,1
2023,REG,7,20:20,MIA,17,PHI,31,14,48,0,7,7,130,-155,3,-112,-108,52,-110,-110,0,outdoors,grass,55,17,14,1
2023,REG,7,20:15,SF,17,MIN,22,5,39,0,8,8,-325,260,-7,-105,-115,44.5,-110,-110,0,dome,sportturf,,,5,1
2023,REG,8,20:15,TB,18,BUF,24,6,42,0,4,4,370,-485,10,-112,-108,43,-110,-110,0,outdoors,a_turf,66,10,6,1
2023,REG,8,13:00,HOU,13,CAR,15,2,28,0,14,14,-162,136,-3,-118,-102,43,-110,-110,0,outdoors,grass,77,14,2,1
2023,REG,8,13:00,LA,20,DAL,43,23,63,0,7,13,250,-310,6.5,-105,-115,44.5,-110,-110,0,closed,matrixturf,,,23,1
2023,REG,8,13:00,MIN,24,GB,10,-14,34,0,6,7,-112,-108,-1,-108,-112,41.5,-108,-112,1,outdoors,grass,39,8,-14,0
2023,REG,8,13:00,NO,38,IND,27,-11,65,0,10,7,-130,110,-2,-110,-110,43.5,-110,-110,0,closed,fieldturf,,,-11,0
2023,REG,8,13:00,NE,17,MIA,31,14,48,0,7,7,300,-380,7.5,-110,-110,46.5,-110,-110,1,outdoors,grass,83,17,14,1
2023,REG,8,13:00,NYJ,13,NYG,10,-3,23,1,14,7,-162,136,-3,-115,-105,35,-112,-108,0,outdoors,fieldturf,52,6,-3,0
2023,REG,8,13:00,JAX,20,PIT,10,-10,30,0,10,7,-135,114,-2.5,-110,-110,41,-110,-110,0,outdoors,grass,58,2,-10,0
2023,REG,8,13:00,ATL,23,TEN,28,5,51,0,7,14,-130,110,-2.5,-110,-110,35,-110,-110,0,outdoors,grass,77,7,5,1
2023,REG,8,13:00,PHI,38,WAS,31,-7,69,0,7,7,-305,245,-7,-110,-110,42.5,-110,-110,1,outdoors,grass,69,4,-7,0
2023,REG,8,16:05,CLE,20,SEA,24,4,44,0,7,7,164,-198,4,-110,-110,39.5,-112,-108,0,outdoors,fieldturf,47,3,4,1
2023,REG,8,16:25,BAL,31,ARI,24,-7,55,0,7,7,-500,380,-9.5,-110,-110,44.5,-110,-110,0,closed,grass,,,-7,0
2023,REG,8,16:25,KC,9,DEN,24,15,33,0,7,7,-340,270,-7,-102,-118,45.5,-110,-110,1,outdoors,grass,26,7,15,1
2023,REG,8,16:25,CIN,31,SF,17,-14,48,0,14,6,170,-205,4,-105,-115,44,-110,-110,0,outdoors,grass,74,10,-14,0
2023,REG,8,20:20,CHI,13,LAC,30,17,43,0,7,7,340,-440,9.5,-108,-112,46,-112,-108,0,dome,matrixturf,,,17,1
2023,REG,8,20:15,LV,14,DET,26,12,40,0,8,8,270,-340,7,-110,-110,46,-110,-110,0,dome,fieldturf,,,12,1
2023,REG,9,20:15,TEN,16,PIT,20,4,36,0,4,4,145,-175,3.5,-120,100,37,-108,-112,0,outdoors,grass,40,5,4,1
2023,REG,9,9:30,MIA,14,KC,21,7,35,0,7,7,-105,-115,1,-112,-108,51,-108,-112,0,outdoors,grass,,,7,1
2023,REG,9,13:00,MIN,31,ATL,28,-3,59,0,7,7,160,-192,3.5,-108,-112,38.5,-112,-108,0,open,fieldturf,,,-3,0
2023,REG,9,13:00,SEA,3,BAL,37,34,40,0,7,7,220,-270,6,-110,-110,44.5,-112,-108,0,outdoors,grass,70,6,34,1
2023,REG,9,13:00,ARI,0,CLE,27,27,27,0,7,7,525,-750,13,-112,-108,38,-110,-110,0,outdoors,grass,56,7,27,1
2023,REG,9,13:00,LA,3,GB,20,17,23,0,7,7,160,-198,3.5,-108,-112,38,-112,-108,0,outdoors,grass,51,8,17,1
2023,REG,9,13:00,TB,37,HOU,39,2,76,0,10,7,124,-148,2.5,100,-120,39.5,-110,-110,0,closed,astroturf,,,2,1
2023,REG,9,13:00,WAS,20,NE,17,-3,37,0,7,7,130,-155,2.5,100,-120,40.5,-110,-110,0,outdoors,fieldturf,62,6,-3,0
2023,REG,9,13:00,CHI,17,NO,24,7,41,0,7,7,340,-440,9,-108,-112,42,-110,-110,0,dome,sportturf,,,7,1
2023,REG,9,16:05,IND,27,CAR,13,-14,40,0,7,7,-130,110,-1.5,-108,-112,45,-110,-110,0,outdoors,grass,75,2,-14,0
2023,REG,9,16:25,NYG,6,LV,30,24,36,0,7,6,-102,-118,1,-110,-110,38.5,-112,-108,0,dome,grass,,,24,1
2023,REG,9,16:25,DAL,23,PHI,28,5,51,0,7,7,145,-175,3.5,-118,-102,46.5,-110,-110,1,outdoors,grass,64,6,5,1
2023,REG,9,20:20,BUF,18,CIN,24,6,42,0,10,7,105,-125,1.5,-108,-112,51,-110,-110,0,outdoors,fieldturf,51,5,6,1
2023,REG,9,20:15,LAC,27,NYJ,6,-21,33,0,8,8,-170,142,-3,-118,-102,41,-110,-110,0,outdoors,fieldturf,48,4,-21,0
2023,REG,10,20:15,CAR,13,CHI,16,3,29,0,4,4,150,-180,3,100,-120,38,-105,-115,0,outdoors,grass,51,8,3,1
2023,REG,10,9:30,IND,10,NE,6,-4,16,0,7,7,-118,-102,-1,-110,-110,42,-110,-110,0,outdoors,grass,,,-4,0
2023,REG,10,13:00,CLE,33,BAL,31,-2,64,0,7,7,210,-258,6,-112,-108,38.5,-108,-112,1,outdoors,grass,49,4,-2,0
2023,REG,10,13:00,HOU,30,CIN,27,-3,57,0,7,7,205,-250,5.5,-110,-110,46,-110,-110,0,outdoors,fieldturf,56,6,-3,0
2023,REG,10,13:00,SF,34,JAX,3,-31,37,0,14,14,-170,142,-3,-112,-108,44.5,-112,-108,0,outdoors,grass,59,11,-31,0
2023,REG,10,13:00,NO,19,MIN,27,8,46,0,7,7,-155,130,-3,-105,-115,41,-112,-108,0,dome,sportturf,,,8,1
2023,REG,10,13:00,GB,19,PIT,23,4,42,0,7,10,140,-166,3,100,-120,38.5,-112,-108,0,outdoors,grass,50,5,4,1
2023,REG,10,13:00,TEN,6,TB,20,14,26,0,10,7,120,-142,2.5,-105,-115,39.5,-110,-110,0,outdoors,grass,85,6,14,1
2023,REG,10,16:05,ATL,23,ARI,25,2,48,0,7,7,-130,110,-2,-110,-110,43.5,-108,-112,0,closed,grass,,,2,1
2023,REG,10,16:05,DET,41,LAC,38,-3,79,0,13,6,-142,120,-2.5,-110,-110,48.5,-110,-110,0,dome,matrixturf,,,-3,0
2023,REG,10,16:25,NYG,17,DAL,49,32,66,0,7,7,1100,-2100,17.5,-108,-112,38.5,-108,-112,1,closed,matrixturf,,,32,1
2023,REG,10,16:25,WAS,26,SEA,29,3,55,0,7,7,220,-270,6,-110,-110,44,-112,-108,0,outdoors,fieldturf,52,4,3,1
2023,REG,10,20:20,NYJ,12,LV,16,4,28,0,6,7,-115,-105,-1,-108,-112,35.5,-112,-108,0,dome,grass,,,4,1
2023,REG,10,20:15,DEN,24,BUF,22,-2,46,0,15,8,310,-395,7.5,-112,-108,47.5,-112,-108,0,outdoors,a_turf,49,10,-2,0
2023,REG,11,20:15,CIN,20,BAL,34,14,54,0,4,4,170,-205,4,-112,-108,46.5,-112,-108,1,outdoors,grass,56,1,14,1
2023,REG,11,13:00,DAL,33,CAR,10,-23,43,0,7,10,-650,470,-11,-110,-110,43,-108,-112,0,outdoors,grass,65,2,-23,0
2023,REG,11,13:00,PIT,10,CLE,13,3,23,0,7,7,120,-142,2.5,-105,-115,34,-108,-112,1,outdoors,grass,48,11,3,1
2023,REG,11,13:00,CHI,26,DET,31,5,57,0,10,7,340,-440,8,-110,-110,48,-110,-110,1,dome,fieldturf,,,5,1
2023,REG,11,13:00,LAC,20,GB,23,3,43,0,7,7,-162,136,-3,-110,-110,44,-108,-112,0,outdoors,grass,45,5,3,1
2023,REG,11,13:00,ARI,16,HOU,21,5,37,0,7,7,205,-250,5.5,-108,-112,48,-110,-110,0,closed,astroturf,,,5,1
2023,REG,11,13:00,TEN,14,JAX,34,20,48,0,7,7,235,-290,6.5,-105,-115,40,-110,-110,1,outdoors,grass,75,3,20,1
2023,REG,11,13:00,LV,13,MIA,20,7,33,0,7,14,700,-1100,14,-110,-110,44.5,-110,-110,0,outdoors,grass,82,7,7,1
2023,REG,11,13:00,NYG,31,WAS,19,-12,50,0,7,7,310,-395,7.5,-110,-110,39,-110,-110,1,outdoors,grass,56,7,-12,0
2023,REG,11,16:05,TB,14,SF,27,13,41,0,7,7,625,-950,13.5,-110,-110,41.5,-108,-112,0,outdoors,grass,65,10,13,1
2023,REG,11,16:25,NYJ,6,BUF,32,26,38,0,7,6,310,-395,8,-108,-112,39.5,-112,-108,1,outdoors,a_turf,40,9,26,1
2023,REG,11,16:25,SEA,16,LA,17,1,33,0,7,14,114,-135,2.5,-110,-110,45,-108,-112,1,dome,matrixturf,,,1,1
2023,REG,11,20:20,MIN,20,DEN,21,1,41,0,7,6,120,-142,2.5,-102,-118,43.5,-115,-105,0,outdoors,grass,53,3,1,1
2023,REG,11,20:15,PHI,21,KC,17,-4,38,0,15,15,124,-148,2.5,100,-120,46,-108,-112,0,outdoors,grass,45,12,-4,0
2023,REG,12,12:30,GB,29,DET,22,-7,51,0,4,4,330,-425,8.5,-105,-115,47,-108,-112,1,dome,fieldturf,,,-7,0
2023,REG,12,16:30,WAS,10,DAL,45,35,55,0,4,4,550,-800,13,-110,-110,48,-112,-110,1,closed,matrixturf,,,35,1
2023,REG,12,20:20,SF,31,SEA,13,-18,44,0,4,4,-355,280,-7,-112,-108,43.5,-115,-105,1,outdoors,fieldturf,39,4,-18,0
2023,REG,12,15:00,MIA,34,NYJ,13,-21,47,0,5,5,-500,380,-9.5,-120,100,40,-110,-110,1,outdoors,fieldturf,48,11,-21,0
2023,REG,12,13:00,NO,15,ATL,24,9,39,0,14,14,-130,110,-2,-110,-110,42,-110,-110,1,closed,fieldturf,,,9,1
2023,REG,12,13:00,PIT,16,CIN,10,-6,26,0,7,10,-135,114,-2,-112,-108,36,-108,-112,1,outdoors,fieldturf,48,9,-6,0
2023,REG,12,13:00,JAX,24,HOU,21,-3,45,0,7,7,-115,-105,-1,-110,-110,48,-108,-112,1,closed,astroturf,,,-3,0
2023,REG,12,13:00,TB,20,IND,27,7,47,0,7,14,130,-155,2.5,-105,-115,45,-112,-108,0,closed,fieldturf,,,7,1
2023,REG,12,13:00,NE,7,NYG,10,3,17,0,14,7,-218,180,-4.5,-108,-112,36.5,-105,-115,0,outdoors,fieldturf,43,6,3,1
2023,REG,12,13:00,CAR,10,TEN,17,7,27,0,7,7,145,-175,3.5,-112,-105,36,-112,-108,0,outdoors,grass,51,13,7,1
2023,REG,12,16:05,LA,37,ARI,14,-23,51,0,7,7,-148,124,-3,-105,-115,45,-112,-108,1,closed,grass,,,-23,0
2023,REG,12,16:05,CLE,12,DEN,29,17,41,0,7,7,105,-125,1.5,-110,-110,37.5,-110,-110,0,outdoors,grass,40,5,17,1
2023,REG,12,16:25,KC,31,LV,17,-14,48,0,6,7,-500,380,-9,-110,-110,42.5,-112,-108,1,dome,grass,,,-14,0
2023,REG,12,16:25,BUF,34,PHI,37,3,71,1,7,6,124,-148,2.5,-105,-115,49,-108,-112,0,outdoors,grass,47,6,3,1
2023,REG,12,20:20,BAL,20,LAC,10,-10,30,0,10,7,-170,142,-3,-115,-105,49,-110,-110,0,dome,matrixturf,,,-10,0
2023,REG,12,20:15,CHI,12,MIN,10,-2,22,0,8,8,140,-166,3,-105,-115,43.5,-110,-110,1,dome,sportturf,,,-2,0
2023,REG,13,20:15,SEA,35,DAL,41,6,76,0,7,7,380,-500,9.5,-102,-118,47.5,-110,-110,0,closed,matrixturf,,,6,1
2023,REG,13,13:00,DEN,17,HOU,22,5,39,0,7,7,142,-170,3.5,-122,102,47.5,-110,-110,0,closed,astroturf,,,5,1
2023,REG,13,13:00,LAC,6,NE,0,-6,6,0,7,7,-225,185,-4.5,-110,-110,38.5,-108,-112,0,outdoors,fieldturf,44,8,-6,0
2023,REG,13,13:00,DET,33,NO,28,-5,61,0,10,7,-198,164,-4,-110,-110,47.5,-108,-112,0,dome,sportturf,,,-5,0
2023,REG,13,13:00,ATL,13,NYJ,8,-5,21,0,7,9,-125,105,-2,-108,-112,33,-110,-110,0,outdoors,fieldturf,50,8,-5,0
2023,REG,13,13:00,ARI,24,PIT,10,-14,34,0,7,7,230,-285,6,-105,-115,41,-112,-108,0,outdoors,grass,56,12,-14,0
2023,REG,13,13:00,IND,31,TEN,28,-3,59,1,7,7,-122,102,-1.5,-110,-110,42,-108,-112,1,outdoors,grass,53,13,-3,0
2023,REG,13,13:00,MIA,45,WAS,15,-30,60,0,9,10,-455,350,-8.5,-112,-108,50,-110,-110,0,outdoors,grass,53,2,-30,0
2023,REG,13,16:05,CAR,18,TB,21,3,39,0,7,7,164,-198,4,-110,-110,37,-110,-110,1,outdoors,grass,81,8,3,1
2023,REG,13,16:25,CLE,19,LA,36,17,55,0,7,7,160,-192,3.5,-110,-110,39.5,-110,-110,0,dome,matrixturf,,,17,1
2023,REG,13,16:25,SF,42,PHI,19,-23,61,0,10,7,-148,124,-3,-105,-115,46.5,-108,-112,0,outdoors,grass,52,44,-23,0
2023,REG,13,20:20,KC,19,GB,27,8,46,0,7,10,-265,215,-5.5,-118,-102,43.5,-105,-115,0,outdoors,grass,31,9,8,1
2023,REG,13,20:15,CIN,34,JAX,31,-3,65,1,8,8,410,-550,10,-105,-115,41,-105,-115,0,outdoors,grass,61,4,-3,0
2023,REG,14,20:15,NE,21,PIT,18,-3,39,0,4,4,220,-270,6,-118,-102,30,-105,-115,0,outdoors,grass,42,5,-3,0
2023,REG,14,13:00,TB,29,ATL,25,-4,54,0,7,7,105,-125,1.5,-108,-112,41.5,-110,-110,1,closed,fieldturf,,,-4,0
2023,REG,14,13:00,LA,31,BAL,37,6,68,1,7,14,285,-360,7.5,-115,-105,42,-110,-110,0,outdoors,grass,57,5,6,1
2023,REG,14,13:00,DET,13,CHI,28,15,41,0,7,13,-170,142,-3,-120,100,44.5,-110,-110,1,outdoors,grass,36,12,15,1
2023,REG,14,13:00,IND,14,CIN,34,20,48,0,7,6,124,-148,3,-118,-102,45,-110,-110,0,outdoors,fieldturf,40,9,20,1
2023,REG,14,13:00,JAX,27,CLE,31,4,58,0,6,7,120,-142,2.5,-108,-112,37.5,-110,-110,0,outdoors,grass,39,11,4,1
2023,REG,14,13:00,CAR,6,NO,28,22,34,0,7,7,200,-245,5.5,-110,-110,39,-110,-110,1,dome,sportturf,,,22,1
2023,REG,14,13:00,HOU,6,NYJ,30,24,36,0,7,7,-175,145,-3.5,-108,-112,33.5,-110,-110,0,outdoors,fieldturf,58,7,24,1
2023,REG,14,16:05,MIN,3,LV,0,-3,3,0,13,14,-155,130,-3,-108,-112,40.5,-108,-112,0,dome,grass,,,-3,0
2023,REG,14,16:05,SEA,16,SF,28,12,44,0,10,7,650,-1000,14.5,-110,-110,44.5,-110,-110,1,outdoors,grass,63,5,12,1
2023,REG,14,16:25,BUF,20,KC,17,-3,37,0,14,7,105,-125,2,-110,-110,49.5,-110,-110,0,outdoors,grass,45,5,-3,0
2023,REG,14,16:25,DEN,24,LAC,7,-17,31,0,7,7,136,-162,3,-112,-108,45,-110,-110,1,dome,matrixturf,,,-17,0
2023,REG,14,20:20,PHI,13,DAL,33,20,46,0,7,10,145,-175,3.5,-118,-102,52.5,-110,-110,1,closed,matrixturf,,,20,1
2023,REG,14,20:15,TEN,28,MIA,27,-1,55,0,8,8,625,-950,14,-110,-110,45,-110,-112,0,outdoors,grass,64,9,-1,0
2023,REG,14,20:15,GB,22,NYG,24,2,46,0,8,15,-265,215,-6,-112,-108,37.5,-110,-110,0,outdoors,fieldturf,39,14,2,1
2023,REG,15,20:15,LAC,21,LV,63,42,84,0,4,4,136,-162,3,-110,-110,36,-110,-110,1,dome,grass,,,42,1
2023,REG,15,13:00,MIN,24,CIN,27,3,51,1,6,6,145,-175,3,-105,-115,41.5,-110,-110,0,outdoors,fieldturf,53,5,3,1
2023,REG,15,16:30,PIT,13,IND,30,17,43,0,9,6,102,-122,1.5,-110,-110,41.5,-110,-110,0,closed,fieldturf,,,17,1
2023,REG,15,20:15,DEN,17,DET,42,25,59,0,6,6,210,-258,5.5,-108,-112,49,-108,-112,0,dome,fieldturf,,,25,1
2023,REG,15,13:00,ATL,7,CAR,9,2,16,0,7,7,-155,130,-3,-102,-118,32,-110,-110,1,outdoors,grass,47,11,2,1
2023,REG,15,13:00,CHI,17,CLE,20,3,37,0,7,7,124,-148,3,-120,100,38,-110,-110,0,outdoors,grass,45,15,3,1
2023,REG,15,13:00,TB,34,GB,20,-14,54,0,7,6,180,-218,4,-110,-110,41.5,-110,-110,0,outdoors,grass,42,8,-14,0
2023,REG,15,13:00,NYJ,0,MIA,30,30,30,0,7,6,275,-345,7.5,-115,-105,36,-110,-110,1,outdoors,grass,76,15,30,1
2023,REG,15,13:00,KC,27,NE,17,-10,44,0,7,10,-485,370,-10,-112,-108,39.5,-110,-110,0,outdoors,fieldturf,53,7,-10,0
2023,REG,15,13:00,NYG,6,NO,24,18,30,0,6,7,205,-250,6,-108,-112,39.5,-110,-110,0,dome,sportturf,,,18,1
2023,REG,15,13:00,HOU,19,TEN,16,-3,35,1,7,6,142,-170,3,100,-120,38,-108,-112,1,outdoors,grass,48,9,-3,0
2023,REG,15,16:05,SF,45,ARI,29,-16,74,0,7,14,-750,525,-12.5,-110,-110,48,-110,-110,1,open,grass,,,-16,0
2023,REG,15,16:05,WAS,20,LA,28,8,48,0,14,7,240,-298,6.5,-108,-112,48.5,-110,-110,0,dome,matrixturf,,,8,1
2023,REG,15,16:25,DAL,10,BUF,31,21,41,0,7,7,114,-135,2,-108,-112,49.5,-110,-110,0,outdoors,a_turf,48,9,21,1
2023,REG,15,20:20,BAL,23,JAX,7,-16,30,0,7,7,-225,185,-4,-110,-110,42.5,-108,-112,0,outdoors,grass,58,13,-16,0
2023,REG,15,20:15,PHI,17,SEA,20,3,37,0,8,8,-238,195,-5,-120,100,46,-112,-108,0,outdoors,fieldturf,46,2,3,1
2023,REG,16,20:15,NO,22,LA,30,8,52,0,4,4,180,-218,4,100,-120,45.5,-112,-108,0,dome,matrixturf,,,8,1
2023,REG,16,16:30,CIN,11,PIT,34,23,45,0,7,7,-155,130,-3,-105,-115,39.5,-110,-110,1,outdoors,grass,49,5,23,1
2023,REG,16,20:00,BUF,24,LAC,22,-2,46,0,6,9,-800,550,-13,-105,-115,44.5,-115,-105,0,dome,matrixturf,,,-2,0
2023,REG,16,13:00,IND,10,ATL,29,19,39,0,8,7,130,-155,3,-115,-105,44,-105,-115,0,closed,fieldturf,,,19,1
2023,REG,16,13:00,GB,33,CAR,30,-3,63,0,7,7,-198,164,-3.5,-112,-108,39.5,-110,-110,0,outdoors,grass,67,1,-3,0
2023,REG,16,13:00,CLE,36,HOU,22,-14,58,0,7,7,-162,136,-3,-110,-110,40,-110,-110,0,closed,astroturf,,,-14,0
2023,REG,16,13:00,DET,30,MIN,24,-6,54,0,8,8,-148,124,-2.5,-125,105,47.5,-102,-118,1,dome,sportturf,,,-6,0
2023,REG,16,13:00,WAS,28,NYJ,30,2,58,0,7,7,140,-166,3,-108,-112,36.5,-110,-110,0,outdoors,fieldturf,45,2,2,1
2023,REG,16,13:00,SEA,20,TEN,17,-3,37,0,6,7,-166,140,-3,-110,-110,42,-108,-112,0,outdoors,grass,61,4,-3,0
2023,REG,16,16:05,JAX,12,TB,30,18,42,0,7,7,-125,105,-2,-110,-110,43,-108,-112,0,outdoors,grass,72,11,18,1
2023,REG,16,16:25,ARI,16,CHI,27,11,43,0,7,7,180,-218,4.5,-110,-110,42,-105,-115,0,outdoors,grass,52,4,11,1
2023,REG,16,16:25,DAL,20,MIA,22,2,42,0,7,7,102,-122,1.5,-110,-110,48.5,100,-120,0,outdoors,grass,75,15,2,1
2023,REG,16,20:15,NE,26,DEN,23,-3,49,0,7,8,270,-340,7,-110,-110,37.5,-110,-110,0,outdoors,grass,28,9,-3,0
2023,REG,16,13:00,LV,20,KC,14,-6,34,0,11,8,440,-600,11,-102,-118,40.5,-110,-110,1,outdoors,grass,38,11,-6,0
2023,REG,16,16:30,NYG,25,PHI,33,8,58,0,8,7,600,-900,14,-112,-108,41,-108,-112,1,outdoors,grass,51,5,8,1
2023,REG,16,20:15,BAL,33,SF,19,-14,52,0,8,8,275,-345,6.5,-105,-115,47.5,-112,-108,0,outdoors,grass,56,8,-14,0
2023,REG,17,20:15,NYJ,20,CLE,37,17,57,0,4,4,270,-345,6.5,-105,-115,33.5,-110,-110,0,outdoors,grass,47,6,17,1
2023,REG,17,20:15,DET,19,DAL,20,1,39,0,6,6,195,-238,5.5,-110,-110,53,-110,-110,0,closed,matrixturf,,,1,1
2023,REG,17,13:00,MIA,19,BAL,56,37,75,0,7,6,150,-180,3,100,-120,47,-108,-112,0,outdoors,grass,50,7,37,1
2023,REG,17,13:00,NE,21,BUF,27,6,48,0,7,8,750,-1200,15,-110,-110,40,-108,-112,1,outdoors,a_turf,35,4,6,1
2023,REG,17,13:00,ATL,17,CHI,37,20,54,0,7,7,130,-155,3,-115,-105,39,-110,-110,0,outdoors,grass,32,5,20,1
2023,REG,17,13:00,TEN,3,HOU,26,23,29,0,7,7,190,-230,5,-105,-115,44,-108,-112,1,closed,astroturf,,,23,1
2023,REG,17,13:00,LV,20,IND,23,3,43,0,6,7,150,-180,3.5,-110,-110,42.5,-105,-115,0,closed,fieldturf,,,3,1
2023,REG,17,13:00,CAR,0,JAX,26,26,26,0,7,7,160,-192,3.5,-110,-110,38,-110,-110,0,outdoors,grass,56,8,26,1
2023,REG,17,13:00,LA,26,NYG,25,-1,51,0,10,6,-298,240,-6,-112,-108,43.5,-108,-112,0,outdoors,fieldturf,41,10,-1,0
2023,REG,17,13:00,ARI,35,PHI,31,-4,66,0,7,6,525,-750,12,-110,-110,48,-110,-110,0,outdoors,grass,45,9,-4,0
2023,REG,17,13:00,NO,23,TB,13,-10,36,0,10,7,124,-148,2.5,100,-120,42.5,-112,-108,1,outdoors,grass,66,5,-10,0
2023,REG,17,13:00,SF,27,WAS,10,-17,37,0,6,7,-1050,675,-14,-115,-105,49,-112,-108,0,outdoors,grass,48,7,-17,0
2023,REG,17,16:05,PIT,30,SEA,23,-7,53,0,8,7,185,-225,4.5,-110,-110,40.5,-108,-112,0,outdoors,fieldturf,47,4,-7,0
2023,REG,17,16:25,LAC,9,DEN,16,7,25,0,8,7,164,-198,3.5,-108,-112,39.5,-110,-110,1,outdoors,grass,41,6,7,1
2023,REG,17,16:25,CIN,17,KC,25,8,42,0,8,6,275,-345,7.5,-115,-105,46,-112,-108,0,outdoors,grass,36,12,8,1
2023,REG,17,20:20,GB,33,MIN,10,-23,43,0,7,7,-108,-112,1,-112,-108,42.5,-112,-108,1,dome,sportturf,,,-23,0
2023,REG,18,16:30,PIT,17,BAL,10,-7,27,0,6,6,-155,130,-3,-105,-115,34,-110,-110,1,outdoors,grass,38,15,-7,0
2023,REG,18,20:15,HOU,23,IND,19,-4,42,0,6,6,-125,105,-1.5,-110,-110,47.5,-108,-112,1,closed,fieldturf,,,-4,0
2023,REG,18,13:00,TB,9,CAR,0,-9,9,0,7,7,-245,200,-5,-105,-115,36.5,-110,-110,1,outdoors,grass,54,19,-9,0
2023,REG,18,13:00,CLE,14,CIN,31,17,45,0,10,7,285,-360,7.5,-115,-105,37,-112,-108,1,outdoors,fieldturf,38,12,17,1
2023,REG,18,13:00,MIN,20,DET,30,10,50,0,7,8,170,-205,3.5,-102,-118,47.5,-110,-110,1,dome,fieldturf,,,10,1
2023,REG,18,13:00,NYJ,17,NE,3,-14,20,0,10,7,120,-142,2.5,-112,-108,28.5,-110,-110,1,outdoors,fieldturf,33,14,-14,0
2023,REG,18,13:00,ATL,17,NO,48,31,65,0,7,7,145,-175,3.5,-122,102,41.5,-108,-112,1,dome,sportturf,,,31,1
2023,REG,18,13:00,JAX,20,TEN,28,8,48,0,7,7,-185,154,-3.5,-102,-118,41.5,-112,-108,1,outdoors,grass,41,11,8,1
2023,REG,18,16:25,SEA,21,ARI,20,-1,41,0,7,7,-155,130,-2.5,-122,102,48,-110,-110,1,closed,grass,,,-1,0
2023,REG,18,16:25,CHI,9,GB,17,8,26,0,7,7,124,-148,2.5,-102,-118,45.5,-108,-112,1,outdoors,grass,34,7,8,1
2023,REG,18,16:25,KC,13,LAC,12,-1,25,0,7,7,154,-185,3.5,-115,-105,35,-108,-115,1,dome,matrixturf,,,-1,0
2023,REG,18,16:25,DEN,14,LV,27,13,41,0,7,7,145,-175,3.5,-118,-102,37.5,-115,-105,1,dome,grass,,,13,1
2023,REG,18,16:25,PHI,10,NYG,27,17,37,0,7,7,-238,190,-4.5,-112,-108,43,-105,-115,1,outdoors,fieldturf,36,12,17,1
2023,REG,18,16:25,LA,21,SF,20,-1,41,0,7,7,200,-245,5.5,-108,-112,40,-108,-112,1,outdoors,grass,52,11,-1,0
2023,REG,18,16:25,DAL,38,WAS,10,-28,48,0,8,7,-850,575,-13,-115,-105,47.5,-110,-110,1,outdoors,grass,48,13,-28,0
2023,REG,18,20:20,BUF,21,MIA,14,-7,35,0,7,7,-155,130,-2.5,-125,105,47.5,-110,-110,1,outdoors,grass,63,6,-7,0
